,Rk,Team,G,MP,FG,FGA,FG_Perc,3P,3PA,3P_Perc,2P,2PA,2P_Perc,FT,FTA,FT_Perc,ORB,DRB,TRB,AST,STL,BLK,TOV,PF,PTS,PTS/G
0,1.0,Golden State Warriors,82,19705,3489,7208,0.484,243,750,0.324,3246,6458,0.503,2313,2858,0.809,915,2385,3300,1978,756,488,1415,2010,9534,116.3
1,2.0,Phoenix Suns*,82,19855,3544,7139,0.496,176,543,0.324,3368,6596,0.511,2159,2716,0.795,1053,2651,3704,2109,668,501,1275,1825,9423,114.9
2,3.0,Denver Nuggets*,82,19805,3716,8015,0.46399999999999997,228,677,0.337,3488,7338,0.475,1737,2201,0.789,1169,2532,3701,2275,814,329,1136,2047,9397,114.6
3,4.0,Portland Trail Blazers*,82,19880,3572,7547,0.473,190,565,0.336,3382,6982,0.484,2031,2734,0.743,1355,2552,3907,2085,749,364,1356,2048,9365,114.2
4,5.0,Orlando Magic,82,19805,3457,7525,0.45899999999999996,116,393,0.295,3341,7132,0.46799999999999997,2060,2725,0.7559999999999999,1304,2465,3769,1993,617,294,1407,1975,9090,110.9
5,6.0,Los Angeles Lakers*,82,19855,3434,7010,0.49,309,841,0.36700000000000005,3125,6169,0.507,1902,2417,0.787,1097,2460,3557,2232,655,445,1226,1737,9079,110.7
6,7.0,Philadelphia 76ers*,82,19805,3437,7028,0.489,189,543,0.348,3248,6485,0.501,1976,2509,0.7879999999999999,1111,2406,3517,1932,687,365,1209,1697,9039,110.2
7,8.0,Boston Celtics*,82,19705,3563,7148,0.498,106,404,0.262,3457,6744,0.513,1791,2153,0.8320000000000001,1066,2707,3773,2423,539,455,1256,1717,9023,110.0
8,9.0,Chicago Bulls*,82,19830,3531,7090,0.498,250,669,0.374,3281,6421,0.511,1665,2140,0.778,1075,2279,3354,2172,814,388,1247,1906,8977,109.5
9,10.0,Indiana Pacers*,82,19880,3381,6807,0.49700000000000005,294,770,0.382,3087,6037,0.511,1906,2335,0.816,940,2388,3328,2023,552,350,1342,1972,8962,109.3
10,11.0,Atlanta Hawks,82,19730,3417,7019,0.48700000000000004,124,411,0.302,3293,6608,0.498,1943,2544,0.764,1273,2187,3460,1820,717,353,1270,1871,8901,108.5
11,12.0,New York Knicks*,82,19830,3434,7089,0.484,236,710,0.332,3198,6379,0.501,1775,2349,0.7559999999999999,1187,2426,3613,2140,714,492,1412,1828,8879,108.3
12,13.0,Washington Bullets,82,19830,3598,7581,0.475,37,197,0.188,3561,7384,0.48200000000000004,1599,2093,0.764,1198,2450,3648,2214,561,424,1201,1929,8832,107.7
13,14.0,Seattle SuperSonics,82,19905,3466,7243,0.479,231,650,0.355,3235,6593,0.491,1606,2167,0.741,1323,2255,3578,1874,701,335,1336,2064,8769,106.9
14,15.0,Utah Jazz*,82,19830,3330,6593,0.505,226,630,0.359,3104,5963,0.521,1874,2484,0.754,953,2501,3454,2212,677,491,1410,2031,8760,106.8
15,16.0,Houston Rockets*,82,19805,3483,7250,0.48,153,491,0.312,3330,6759,0.493,1633,2267,0.72,1217,2638,3855,2194,809,551,1513,1934,8752,106.7
16,17.0,San Antonio Spurs*,82,19730,3388,6997,0.484,54,226,0.239,3334,6771,0.49200000000000005,1888,2535,0.745,1163,2474,3637,2037,799,554,1399,1854,8718,106.3
17,18.0,Milwaukee Bucks*,82,19830,3380,7146,0.473,209,670,0.312,3171,6476,0.49,1722,2273,0.758,1108,2246,3354,2046,826,326,1315,2086,8691,106.0
18,19.0,Detroit Pistons*,82,19805,3333,6980,0.478,177,541,0.327,3156,6439,0.49,1713,2252,0.7609999999999999,1185,2458,3643,1996,512,418,1233,1961,8556,104.3
19,20.0,Los Angeles Clippers,82,19805,3319,6853,0.484,56,230,0.243,3263,6623,0.493,1815,2458,0.738,1056,2362,3418,1978,782,507,1547,1859,8509,103.8
20,21.0,Cleveland Cavaliers*,82,19880,3214,6977,0.461,346,851,0.40700000000000003,2868,6126,0.46799999999999997,1637,2201,0.7440000000000001,1128,2380,3508,2106,645,512,1243,1666,8411,102.6
21,22.0,Dallas Mavericks*,82,19855,3246,6831,0.475,157,486,0.32299999999999995,3089,6345,0.48700000000000004,1735,2261,0.767,1042,2419,3461,1776,664,398,1228,1733,8384,102.2
22,23.0,Sacramento Kings,82,19755,3305,7056,0.46799999999999997,216,649,0.33299999999999996,3089,6407,0.48200000000000004,1515,1964,0.7709999999999999,952,2363,3315,2052,546,392,1239,1863,8341,101.7
23,24.0,Miami Heat,82,19730,3383,7345,0.461,88,300,0.293,3295,7045,0.46799999999999997,1393,2028,0.687,1242,2313,3555,1957,736,388,1557,2123,8247,100.6
24,25.0,Charlotte Hornets,82,19755,3270,7183,0.455,205,611,0.336,3065,6572,0.466,1487,1967,0.7559999999999999,962,2211,3173,2080,778,262,1226,1889,8232,100.4
25,26.0,New Jersey Nets,82,19705,3157,7415,0.426,140,506,0.27699999999999997,3017,6909,0.43700000000000006,1754,2350,0.746,1363,2324,3687,1475,774,481,1360,1952,8208,100.1
26,27.0,Minnesota Timberwolves,82,19855,3067,6876,0.446,73,294,0.248,2994,6582,0.455,1596,2137,0.747,1196,2053,3249,1844,789,344,1197,1901,7803,95.2
27,,League Average,82,19806,3404,7146,0.47600000000000003,179,541,0.331,3225,6605,0.488,1786,2338,0.764,1135,2403,3538,2038,699,415,1317,1907,8773,107.0
28,1.0,Denver Nuggets,82,19730,3901,8868,0.44,300,1059,0.28300000000000003,3601,7809,0.461,1726,2263,0.763,1520,2530,4050,2005,856,406,1332,2235,9828,119.9
29,2.0,Golden State Warriors*,82,19805,3566,7346,0.485,270,801,0.337,3296,6545,0.504,2162,2761,0.7829999999999999,1113,2306,3419,1954,803,378,1359,2207,9564,116.6
30,3.0,Portland Trail Blazers*,82,19905,3577,7369,0.485,341,904,0.377,3236,6465,0.501,1912,2538,0.753,1202,2561,3763,2254,724,410,1309,1975,9407,114.7
31,4.0,Phoenix Suns*,82,19730,3573,7199,0.496,138,432,0.319,3435,6767,0.508,2064,2680,0.77,1132,2598,3730,2209,687,535,1302,1850,9348,114.0
32,5.0,Indiana Pacers*,82,19805,3450,6994,0.493,249,749,0.332,3201,6245,0.513,2010,2479,0.8109999999999999,1018,2376,3394,2181,658,357,1355,2088,9159,111.7
33,6.0,Boston Celtics*,82,19805,3695,7214,0.512,109,346,0.315,3586,6868,0.522,1646,1997,0.8240000000000001,1088,2697,3785,2160,672,565,1320,1695,9145,111.5
34,7.0,Chicago Bulls*,82,19755,3632,7125,0.51,155,424,0.366,3477,6701,0.519,1605,2111,0.76,1148,2342,3490,2212,822,438,1184,1751,9024,110.0
35,8.0,Atlanta Hawks*,82,19755,3349,7223,0.46399999999999997,271,836,0.324,3078,6387,0.48200000000000004,2034,2544,0.8,1235,2420,3655,1864,729,374,1231,1768,9003,109.8
36,9.0,San Antonio Spurs*,82,19830,3409,6988,0.488,81,297,0.273,3328,6691,0.49700000000000005,1883,2459,0.7659999999999999,1131,2657,3788,2140,670,571,1445,1896,8782,107.1
37,10.0,Houston Rockets*,82,19855,3403,7287,0.467,316,989,0.32,3087,6298,0.49,1631,2200,0.741,1275,2508,3783,1906,796,409,1402,1874,8753,106.7
38,11.0,Seattle SuperSonics*,82,19880,3500,7117,0.49200000000000005,136,427,0.319,3364,6690,0.503,1608,2143,0.75,1222,2173,3395,2042,861,380,1404,1973,8744,106.6
39,12.0,Milwaukee Bucks*,82,19855,3337,6948,0.48,257,753,0.341,3080,6195,0.49700000000000005,1796,2241,0.8009999999999999,1079,2162,3241,2075,894,330,1321,2033,8727,106.4
40,13.0,Los Angeles Lakers*,82,19830,3343,6911,0.484,226,744,0.304,3117,6167,0.505,1805,2261,0.7979999999999999,1078,2440,3518,2091,642,384,1203,1524,8717,106.3
41,14.0,Orlando Magic,82,19780,3298,7256,0.455,270,754,0.358,3028,6502,0.466,1818,2447,0.743,1233,2429,3662,1809,602,306,1391,1976,8684,105.9
42,15.0,Philadelphia 76ers*,82,20080,3289,6925,0.475,195,618,0.316,3094,6307,0.491,1868,2366,0.79,984,2496,3480,1824,678,479,1230,1629,8641,105.4
43,16.0,Utah Jazz*,82,19780,3214,6537,0.49200000000000005,148,458,0.32299999999999995,3066,6079,0.504,1951,2472,0.789,867,2474,3341,2217,652,451,1305,1796,8527,104.0
44,17.0,Los Angeles Clippers,82,19805,3391,7315,0.46399999999999997,113,434,0.26,3278,6881,0.47600000000000003,1596,2273,0.7020000000000001,1246,2500,3746,2119,725,507,1438,2043,8491,103.5
45,18.0,New York Knicks*,82,19955,3308,6822,0.485,185,558,0.332,3123,6264,0.499,1654,2147,0.77,1053,2436,3489,2172,638,418,1379,1764,8455,103.1
46,19.0,New Jersey Nets,82,19830,3311,7459,0.444,161,586,0.275,3150,6873,0.45799999999999996,1658,2245,0.7390000000000001,1400,2348,3748,1782,748,600,1423,1954,8441,102.9
47,20.0,Charlotte Hornets,82,19805,3286,7033,0.467,131,417,0.314,3155,6616,0.47700000000000004,1725,2214,0.779,1027,2200,3227,2019,759,304,1290,1946,8428,102.8
48,21.0,Miami Heat,82,19780,3280,7139,0.45899999999999996,140,464,0.302,3140,6675,0.47,1649,2307,0.715,1232,2302,3534,1904,756,387,1551,2080,8349,101.8
49,22.0,Cleveland Cavaliers,82,19830,3259,6857,0.475,160,479,0.33399999999999996,3099,6378,0.486,1665,2176,0.765,1011,2329,3340,2240,643,450,1281,1672,8343,101.7
50,23.0,Washington Bullets,82,19855,3390,7268,0.466,55,284,0.19399999999999998,3335,6984,0.478,1478,2028,0.7290000000000001,1173,2390,3563,2081,588,468,1359,1927,8313,101.4
51,24.0,Detroit Pistons*,82,19805,3194,6875,0.465,131,440,0.298,3063,6435,0.47600000000000003,1686,2211,0.763,1206,2452,3658,1825,487,367,1181,1869,8205,100.1
52,25.0,Dallas Mavericks,82,19805,3245,6890,0.47100000000000003,193,600,0.322,3052,6290,0.485,1512,1986,0.7609999999999999,984,2360,3344,1821,581,397,1186,1840,8195,99.9
53,26.0,Minnesota Timberwolves,82,19905,3265,7276,0.449,108,381,0.28300000000000003,3157,6895,0.45799999999999996,1531,2082,0.735,1275,2113,3388,1885,712,440,1062,1864,8169,99.6
54,27.0,Sacramento Kings,82,19705,3086,6818,0.45299999999999996,216,578,0.374,2870,6240,0.46,1540,2105,0.732,1027,2218,3245,1991,631,513,1272,2075,7928,96.7
55,,League Average,82,19824,3391,7150,0.474,187,586,0.32,3204,6565,0.488,1749,2287,0.765,1147,2401,3547,2029,704,431,1315,1900,8717,106.3
56,1.0,Golden State Warriors*,82,19880,3767,7427,0.507,254,763,0.33299999999999996,3513,6664,0.527,1944,2606,0.746,1137,2376,3513,2064,854,375,1353,2049,9732,118.7
57,2.0,Indiana Pacers*,82,19955,3498,7079,0.494,333,940,0.354,3165,6139,0.516,1868,2364,0.79,1083,2564,3647,2398,705,393,1402,2137,9197,112.2
58,3.0,Phoenix Suns*,82,19805,3553,7219,0.49200000000000005,227,596,0.381,3326,6623,0.502,1861,2397,0.7759999999999999,1088,2558,3646,2202,673,582,1242,1852,9194,112.1
59,4.0,Portland Trail Blazers*,82,19880,3476,7352,0.473,325,944,0.344,3151,6408,0.49200000000000005,1858,2463,0.754,1294,2549,3843,2065,753,410,1328,1983,9135,111.4
60,5.0,Chicago Bulls*,82,19830,3643,7168,0.508,138,454,0.304,3505,6714,0.522,1587,2132,0.7440000000000001,1173,2439,3612,2279,672,480,1088,1693,9011,109.9
61,6.0,Charlotte Hornets,82,19805,3613,7568,0.47700000000000004,117,369,0.317,3496,7199,0.486,1637,2168,0.755,1164,2367,3531,2284,822,309,1273,1819,8980,109.5
62,7.0,Cleveland Cavaliers*,82,19805,3427,7025,0.488,253,708,0.35700000000000004,3174,6317,0.502,1819,2259,0.805,1041,2450,3491,2260,616,621,1073,1556,8926,108.9
63,8.0,Utah Jazz*,82,19880,3379,6866,0.49200000000000005,158,458,0.345,3221,6408,0.503,1961,2490,0.7879999999999999,1097,2543,3640,2188,715,448,1264,1746,8877,108.3
64,9.0,Boston Celtics*,82,19780,3543,7196,0.49200000000000005,110,359,0.306,3433,6837,0.502,1549,1917,0.8079999999999999,1095,2583,3678,2072,636,484,1165,1686,8745,106.6
65,10.0,Seattle SuperSonics*,82,19855,3380,7128,0.474,205,647,0.317,3175,6481,0.49,1772,2263,0.7829999999999999,1282,2257,3539,1877,775,448,1323,1952,8737,106.5
66,11.0,Atlanta Hawks,82,19905,3492,7476,0.467,210,671,0.313,3282,6805,0.48200000000000004,1517,2074,0.731,1288,2498,3786,2123,793,320,1255,1771,8711,106.2
67,12.0,New Jersey Nets*,82,19780,3473,7580,0.45799999999999996,224,670,0.33399999999999996,3249,6910,0.47,1471,2009,0.732,1512,2392,3904,1937,736,615,1392,1834,8641,105.4
68,13.0,Milwaukee Bucks,82,19880,3321,7216,0.46,371,1005,0.369,2950,6211,0.475,1596,2104,0.759,1297,2172,3469,2018,863,317,1350,1904,8609,105.0
69,14.0,Miami Heat*,82,19830,3256,7061,0.461,257,751,0.342,2999,6310,0.475,1839,2329,0.79,1187,2366,3553,1749,670,373,1377,1819,8608,105.0
70,15.0,Sacramento Kings,82,19830,3348,7189,0.466,238,675,0.353,3110,6514,0.47700000000000004,1615,2162,0.747,1054,2354,3408,1957,727,618,1360,1763,8549,104.3
71,16.0,San Antonio Spurs*,82,19780,3377,7090,0.47600000000000003,118,404,0.292,3259,6686,0.48700000000000004,1652,2246,0.736,1229,2552,3781,2010,729,608,1308,1799,8524,104.0
72,17.0,Los Angeles Clippers*,82,19830,3347,7076,0.473,145,502,0.289,3202,6574,0.48700000000000004,1601,2223,0.72,1132,2393,3525,2053,824,498,1269,1873,8440,102.9
73,18.0,Washington Bullets,82,19855,3364,7301,0.461,146,537,0.272,3218,6764,0.47600000000000003,1521,1956,0.778,1069,2345,3414,2011,713,422,1254,1852,8395,102.4
74,19.0,Houston Rockets,82,19880,3273,6894,0.475,329,959,0.34299999999999997,2944,5935,0.496,1491,2020,0.738,1074,2432,3506,2058,656,571,1378,1769,8366,102.0
75,20.0,Philadelphia 76ers,82,19755,3187,6761,0.47100000000000003,227,680,0.33399999999999996,2960,6081,0.48700000000000004,1757,2267,0.775,1058,2309,3367,1755,692,482,1238,1582,8358,101.9
76,21.0,Orlando Magic,82,19705,3220,7102,0.45299999999999996,197,608,0.324,3023,6494,0.466,1693,2268,0.746,1171,2329,3500,1792,643,367,1389,1977,8330,101.6
77,22.0,New York Knicks*,82,19855,3312,6947,0.47700000000000004,201,618,0.325,3111,6329,0.49200000000000005,1503,2049,0.7340000000000001,1185,2489,3674,2130,634,382,1242,1905,8328,101.6
78,23.0,Minnesota Timberwolves,82,19805,3366,7342,0.45799999999999996,126,394,0.32,3240,6948,0.466,1379,1857,0.743,1167,2168,3335,2025,619,526,1157,1866,8237,100.5
79,24.0,Los Angeles Lakers*,82,19830,3183,6977,0.456,119,445,0.267,3064,6532,0.469,1744,2278,0.7659999999999999,1156,2196,3352,1803,756,400,1089,1543,8229,100.4
80,25.0,Denver Nuggets,82,19780,3262,7380,0.442,126,418,0.301,3136,6962,0.45,1526,2067,0.738,1350,2352,3702,1553,773,461,1447,1984,8176,99.7
81,26.0,Detroit Pistons*,82,19780,3191,6867,0.465,165,526,0.314,3026,6341,0.47700000000000004,1566,2108,0.743,1210,2421,3631,1899,546,357,1212,1646,8113,98.9
82,27.0,Dallas Mavericks,82,19755,3120,7104,0.439,268,797,0.336,2852,6307,0.452,1499,1999,0.75,1194,2439,3633,1630,536,349,1202,1867,8007,97.6
83,,League Average,82,19826,3384,7163,0.47200000000000003,207,626,0.331,3177,6537,0.486,1660,2188,0.759,1177,2403,3581,2007,709,452,1275,1823,8635,105.3
84,1.0,Phoenix Suns*,82,19730,3494,7093,0.493,398,1095,0.363,3096,5998,0.516,1912,2539,0.753,1141,2510,3651,2087,752,455,1359,1739,9298,113.4
85,2.0,Charlotte Hornets*,82,19755,3512,7210,0.48700000000000004,175,537,0.326,3337,6673,0.5,1831,2374,0.7709999999999999,1095,2508,3603,2161,639,473,1325,1790,9030,110.1
86,3.0,Golden State Warriors,82,19905,3474,7212,0.48200000000000004,298,852,0.35,3176,6360,0.499,1768,2465,0.7170000000000001,1219,2384,3603,2010,693,383,1451,2056,9014,109.9
87,4.0,Portland Trail Blazers*,82,19905,3361,7343,0.45799999999999996,275,843,0.326,3086,6500,0.475,1901,2551,0.745,1226,2507,3733,1969,770,425,1215,1892,8898,108.5
88,5.0,Seattle SuperSonics*,82,19780,3473,7140,0.486,218,610,0.35700000000000004,3255,6530,0.498,1720,2259,0.7609999999999999,1222,2254,3476,1906,944,409,1267,1971,8884,108.3
89,6.0,Sacramento Kings,82,19780,3360,7264,0.46299999999999997,262,788,0.332,3098,6476,0.478,1865,2447,0.762,1137,2281,3418,2075,768,348,1364,2085,8847,107.9
90,7.0,Indiana Pacers*,82,19755,3371,7022,0.48,257,789,0.326,3114,6233,0.5,1837,2399,0.7659999999999999,1220,2455,3675,2144,615,403,1256,2045,8836,107.8
91,8.0,Cleveland Cavaliers*,82,19830,3425,6887,0.49700000000000005,283,742,0.381,3142,6145,0.511,1699,2119,0.802,929,2496,3425,2349,615,536,1120,1580,8832,107.7
92,9.0,Atlanta Hawks*,82,19830,3392,7272,0.466,382,1076,0.355,3010,6196,0.486,1648,2221,0.742,1290,2344,3634,2084,806,278,1339,1807,8814,107.5
93,10.0,Los Angeles Clippers*,82,19805,3544,7329,0.484,133,491,0.271,3411,6838,0.499,1562,2177,0.718,1183,2360,3543,2242,847,491,1338,1920,8783,107.1
94,11.0,Utah Jazz*,82,19755,3336,6828,0.489,130,414,0.314,3206,6414,0.5,1907,2491,0.7659999999999999,1041,2463,3504,2177,746,344,1270,1965,8709,106.2
95,12.0,San Antonio Spurs*,82,19855,3311,6762,0.49,236,692,0.341,3075,6070,0.507,1794,2346,0.765,919,2542,3461,2012,582,514,1227,1844,8652,105.5
96,13.0,Orlando Magic,82,19880,3257,6708,0.486,317,889,0.35700000000000004,2940,5819,0.505,1821,2495,0.73,1040,2566,3606,1952,542,467,1429,1925,8652,105.5
97,14.0,Denver Nuggets,82,19830,3352,7282,0.46,138,454,0.304,3214,6828,0.47100000000000003,1784,2360,0.7559999999999999,1266,2564,3830,1735,651,565,1413,2039,8626,105.2
98,15.0,Chicago Bulls*,82,19830,3475,7205,0.48200000000000004,244,669,0.365,3231,6536,0.494,1431,1952,0.733,1290,2283,3573,2133,783,410,1103,1804,8625,105.2
99,16.0,Philadelphia 76ers,82,19930,3225,7075,0.456,330,941,0.35100000000000003,2895,6134,0.47200000000000003,1776,2259,0.7859999999999999,1031,2431,3462,2038,672,566,1362,1604,8556,104.3
100,17.0,Los Angeles Lakers*,82,19830,3309,6994,0.473,187,626,0.299,3122,6368,0.49,1741,2304,0.7559999999999999,1103,2288,3391,2013,782,431,1266,1778,8546,104.2
101,18.0,Houston Rockets*,82,19780,3280,6744,0.486,387,1073,0.361,2893,5671,0.51,1584,2090,0.758,985,2532,3517,2115,682,543,1295,1699,8531,104.0
102,19.0,Boston Celtics*,82,19780,3453,7093,0.48700000000000004,110,383,0.287,3343,6710,0.498,1486,1912,0.777,1076,2436,3512,1999,647,458,1174,1862,8502,103.7
103,20.0,Miami Heat,82,20005,3127,6850,0.456,333,940,0.354,2794,5910,0.473,1908,2476,0.7709999999999999,1134,2384,3518,1688,609,350,1287,2011,8495,103.6
104,21.0,New Jersey Nets*,82,19780,3272,7084,0.462,155,488,0.318,3117,6596,0.473,1732,2258,0.767,1291,2506,3797,1872,693,526,1355,1892,8431,102.8
105,22.0,Milwaukee Bucks,82,19730,3268,6924,0.47200000000000003,312,936,0.33299999999999996,2956,5988,0.494,1544,2081,0.742,1050,2113,3163,2084,863,393,1363,1978,8392,102.3
106,23.0,Washington Bullets,82,19805,3302,7065,0.467,174,578,0.301,3128,6487,0.48200000000000004,1575,2107,0.748,1031,2317,3348,2110,673,359,1323,1795,8353,101.9
107,24.0,New York Knicks*,82,19930,3209,6898,0.465,193,604,0.32,3016,6294,0.479,1717,2316,0.741,1150,2660,3810,2125,680,372,1296,2111,8328,101.6
108,25.0,Detroit Pistons,82,19780,3267,7211,0.45299999999999996,292,908,0.322,2975,6303,0.47200000000000003,1426,1957,0.7290000000000001,1293,2315,3608,1941,580,249,1152,1747,8252,100.6
109,26.0,Dallas Mavericks,82,19730,3164,7271,0.435,283,837,0.33799999999999997,2881,6434,0.44799999999999995,1530,2171,0.705,1234,2265,3499,1683,649,355,1459,2302,8141,99.3
110,27.0,Minnesota Timberwolves,82,19855,3043,6529,0.466,166,569,0.292,2877,5960,0.483,1794,2247,0.7979999999999999,940,2204,3144,2001,649,455,1422,2028,8046,98.1
111,,League Average,82,19821,3335,7048,0.473,247,734,0.336,3088,6314,0.489,1715,2273,0.754,1131,2406,3537,2026,701,428,1305,1899,8632,105.3
112,1.0,Phoenix Suns*,82,19705,3429,7080,0.484,344,1042,0.33,3085,6038,0.511,1674,2301,0.728,1220,2453,3673,2261,745,460,1305,1639,8876,108.2
113,2.0,Golden State Warriors*,82,19780,3512,7145,0.49200000000000005,291,859,0.33899999999999997,3221,6286,0.512,1529,2304,0.664,1183,2396,3579,2198,804,511,1433,1789,8844,107.9
114,3.0,Portland Trail Blazers*,82,19755,3371,7427,0.45399999999999996,272,770,0.353,3099,6657,0.466,1781,2396,0.743,1302,2460,3762,2070,744,409,1210,1827,8795,107.3
115,4.0,Charlotte Hornets,82,19830,3382,7100,0.47600000000000003,336,916,0.36700000000000005,3046,6184,0.493,1632,2135,0.764,1019,2475,3494,2214,724,394,1266,1747,8732,106.5
116,5.0,Seattle SuperSonics*,82,19730,3338,6901,0.484,242,722,0.335,3096,6179,0.501,1769,2374,0.745,1148,2233,3381,2112,1053,365,1262,1914,8687,105.9
117,6.0,Orlando Magic*,82,19730,3341,6883,0.485,394,1137,0.34700000000000003,2947,5746,0.513,1590,2346,0.6779999999999999,1177,2356,3533,2070,683,456,1327,1713,8666,105.7
118,7.0,Miami Heat*,82,19805,3197,6896,0.46399999999999997,337,997,0.33799999999999997,2860,5899,0.485,1744,2223,0.785,1235,2407,3642,1856,643,374,1315,2024,8475,103.4
119,8.0,New Jersey Nets*,82,19830,3169,7115,0.445,223,683,0.327,2946,6432,0.45799999999999996,1900,2495,0.762,1300,2556,3856,1900,696,576,1196,1693,8461,103.2
120,9.0,Los Angeles Clippers,82,19780,3343,7163,0.467,252,831,0.303,3091,6332,0.488,1509,2128,0.7090000000000001,1120,2410,3530,2169,807,421,1474,1769,8447,103.0
121,10.0,Utah Jazz*,82,19830,3207,6729,0.47700000000000004,179,559,0.32,3028,6170,0.491,1761,2379,0.74,1059,2385,3444,2179,751,364,1191,1988,8354,101.9
122,11.0,Atlanta Hawks*,82,19755,3247,7039,0.461,268,830,0.32299999999999995,2979,6209,0.48,1556,2070,0.752,1250,2423,3673,2056,915,449,1252,1625,8318,101.4
123,12.0,Cleveland Cavaliers*,82,19855,3133,6731,0.465,294,813,0.36200000000000004,2839,5918,0.48,1736,2254,0.77,1090,2353,3443,2049,705,426,1136,1701,8296,101.2
124,13.0,Houston Rockets*,82,19780,3197,6733,0.475,429,1285,0.33399999999999996,2768,5448,0.508,1469,1978,0.743,926,2619,3545,2087,717,485,1338,1646,8292,101.1
125,14.0,Sacramento Kings,82,19755,3179,7027,0.452,257,729,0.353,2922,6298,0.46399999999999997,1676,2292,0.731,1122,2349,3471,2029,669,355,1333,1979,8291,101.1
126,15.0,Indiana Pacers*,82,19755,3167,6516,0.486,184,500,0.368,2983,6016,0.496,1762,2387,0.738,1130,2409,3539,2055,706,457,1440,1974,8280,101.0
127,16.0,Boston Celtics,82,19905,3333,7057,0.47200000000000003,138,477,0.289,3195,6580,0.486,1463,2003,0.73,1037,2380,3417,1928,674,440,1242,1849,8267,100.8
128,17.0,Washington Bullets,82,19705,3195,6826,0.46799999999999997,221,744,0.297,2974,6082,0.489,1618,2162,0.748,1071,2189,3260,1823,701,321,1403,1715,8229,100.4
129,18.0,Los Angeles Lakers,82,19755,3291,7316,0.45,241,803,0.3,3050,6513,0.46799999999999997,1410,1967,0.7170000000000001,1260,2204,3464,1983,751,461,1197,1877,8233,100.4
130,19.0,Denver Nuggets*,82,19755,3156,6781,0.465,170,597,0.285,2986,6184,0.483,1739,2423,0.718,1105,2557,3662,1763,679,686,1422,1926,8221,100.3
131,20.0,San Antonio Spurs*,82,19780,3178,6688,0.475,249,714,0.349,2929,5974,0.49,1597,2151,0.742,1189,2597,3786,1896,561,450,1198,1662,8202,100.0
132,21.0,New York Knicks*,82,19755,3098,6735,0.46,316,908,0.348,2782,5827,0.47700000000000004,1564,2097,0.746,1175,2542,3717,2067,752,385,1360,2001,8076,98.5
133,22.0,Chicago Bulls*,82,19780,3245,6815,0.47600000000000003,233,659,0.354,3012,6156,0.489,1310,1859,0.705,1143,2391,3534,2102,740,354,1306,1750,8033,98.0
134,23.0,Philadelphia 76ers,82,19805,3103,6819,0.455,318,942,0.33799999999999997,2785,5877,0.474,1509,2112,0.7140000000000001,1012,2394,3406,1827,663,525,1368,1488,8033,98.0
135,24.0,Detroit Pistons,82,19730,3169,7017,0.452,358,1041,0.344,2811,5976,0.47,1253,1715,0.731,1027,2320,3347,1767,602,309,1236,1935,7949,96.9
136,25.0,Milwaukee Bucks,82,19705,3044,6807,0.447,331,1019,0.325,2713,5788,0.469,1530,2181,0.7020000000000001,1126,2154,3280,1946,800,407,1343,1821,7949,96.9
137,26.0,Minnesota Timberwolves,82,19730,2985,6535,0.457,183,557,0.32899999999999996,2802,5978,0.469,1777,2303,0.772,990,2343,3333,1967,600,440,1478,2016,7930,96.7
138,27.0,Dallas Mavericks,82,19730,3055,7070,0.43200000000000005,241,773,0.312,2814,6297,0.447,1450,1942,0.747,1271,2150,3421,1629,767,299,1393,2007,7801,95.1
139,,League Average,82,19771,3225,6924,0.466,270,811,0.33299999999999996,2954,6113,0.483,1604,2184,0.7340000000000001,1137,2389,3526,2000,728,429,1312,1818,8324,101.5
140,1.0,Orlando Magic*,82,19930,3460,6899,0.502,523,1412,0.37,2937,5487,0.535,1648,2465,0.669,1149,2457,3606,2281,672,488,1297,1726,9091,110.9
141,2.0,Phoenix Suns*,82,19830,3356,6967,0.48200000000000004,584,1584,0.369,2772,5383,0.515,1777,2352,0.7559999999999999,1027,2403,3430,2198,687,312,1167,1839,9073,110.6
142,3.0,Seattle SuperSonics*,82,19830,3310,6741,0.491,491,1305,0.376,2819,5436,0.519,1944,2564,0.758,1068,2337,3405,2115,917,392,1295,2067,9055,110.4
143,4.0,San Antonio Spurs*,82,19855,3236,6687,0.484,434,1158,0.375,2802,5529,0.507,1836,2487,0.738,1029,2661,3690,1919,656,456,1246,1871,8742,106.6
144,5.0,Utah Jazz*,82,19780,3243,6339,0.512,301,801,0.376,2942,5538,0.531,1939,2483,0.7809999999999999,874,2412,3286,2256,758,392,1289,2045,8726,106.4
145,6.0,Golden State Warriors,82,19905,3217,6873,0.46799999999999997,546,1602,0.341,2671,5271,0.507,1687,2395,0.7040000000000001,1101,2371,3472,2017,649,391,1497,1804,8667,105.7
146,7.0,Los Angeles Lakers*,82,19905,3284,7088,0.46299999999999997,525,1492,0.35200000000000004,2759,5596,0.493,1523,2072,0.735,1126,2316,3442,2078,750,563,1243,1933,8616,105.1
147,8.0,Houston Rockets*,82,19730,3159,6579,0.48,646,1757,0.368,2513,4822,0.521,1527,2039,0.7490000000000001,880,2440,3320,2060,721,514,1322,1714,8491,103.5
148,9.0,Dallas Mavericks,82,19930,3227,7342,0.44,386,1200,0.322,2841,6142,0.46299999999999997,1622,2210,0.7340000000000001,1514,2433,3947,1941,579,348,1345,1811,8462,103.2
149,10.0,Portland Trail Blazers*,82,19705,3217,7134,0.451,462,1266,0.365,2755,5868,0.469,1555,2230,0.6970000000000001,1352,2443,3795,1846,668,467,1212,2024,8451,103.1
150,11.0,Boston Celtics*,82,19805,3179,6847,0.46399999999999997,362,984,0.368,2817,5863,0.48,1708,2268,0.753,1156,2320,3476,1783,612,361,1305,1975,8428,102.8
151,12.0,Chicago Bulls*,82,19830,3191,6710,0.47600000000000003,443,1187,0.373,2748,5523,0.498,1500,2065,0.726,1106,2294,3400,1970,797,352,1297,1962,8325,101.5
152,13.0,Denver Nuggets*,82,19980,3098,6461,0.479,413,1160,0.35600000000000004,2685,5301,0.507,1700,2305,0.738,1040,2402,3442,1836,660,585,1381,2063,8309,101.3
153,14.0,Miami Heat,82,19805,3144,6738,0.467,436,1182,0.369,2708,5556,0.48700000000000004,1569,2133,0.736,1092,2272,3364,1779,662,298,1291,2000,8293,101.1
154,15.0,Charlotte Hornets*,82,19805,3051,6438,0.474,560,1409,0.397,2491,5029,0.495,1587,2042,0.777,832,2395,3227,2072,620,399,1224,1685,8249,100.6
155,16.0,Washington Bullets,82,19855,3176,6899,0.46,433,1264,0.34299999999999997,2743,5635,0.48700000000000004,1457,2013,0.7240000000000001,1044,2219,3263,1749,648,404,1301,1949,8242,100.5
156,17.0,Milwaukee Bucks,82,19855,3022,6586,0.45899999999999996,494,1349,0.366,2528,5237,0.483,1608,2259,0.7120000000000001,1063,2187,3250,1737,674,359,1393,1858,8146,99.3
157,18.0,Indiana Pacers*,82,19780,2983,6248,0.47700000000000004,374,985,0.38,2609,5263,0.496,1796,2390,0.7509999999999999,1051,2290,3341,1877,703,363,1340,1939,8136,99.2
158,19.0,New York Knicks*,82,19780,2985,6394,0.467,532,1446,0.368,2453,4948,0.496,1552,2114,0.7340000000000001,929,2473,3402,2055,591,387,1305,2102,8054,98.2
159,20.0,Detroit Pistons,82,19730,3060,6633,0.461,494,1396,0.354,2566,5237,0.49,1439,1941,0.741,958,2204,3162,1872,705,420,1318,2151,8053,98.2
160,21.0,Sacramento Kings,82,19855,3025,6463,0.46799999999999997,359,1037,0.34600000000000003,2666,5426,0.491,1647,2317,0.711,1073,2325,3398,1824,650,457,1449,2040,8056,98.2
161,22.0,New Jersey Nets,82,19880,2939,6738,0.436,414,1297,0.319,2525,5441,0.46399999999999997,1750,2305,0.759,1213,2569,3782,1884,544,548,1300,1844,8042,98.1
162,23.0,Los Angeles Clippers,82,19880,3060,6888,0.444,331,1051,0.315,2729,5837,0.46799999999999997,1476,2079,0.71,1064,2076,3140,1805,787,435,1334,2152,7927,96.7
163,24.0,Atlanta Hawks*,82,19855,2986,6680,0.447,539,1580,0.341,2447,5100,0.48,1410,1948,0.7240000000000001,1104,2272,3376,1757,738,412,1221,1804,7921,96.6
164,25.0,Philadelphia 76ers,82,19805,2949,6577,0.44799999999999995,355,936,0.379,2594,5641,0.46,1567,2125,0.737,1105,2230,3335,1566,643,576,1355,1835,7820,95.4
165,26.0,Minnesota Timberwolves,82,19780,2792,6219,0.449,318,1016,0.313,2474,5203,0.475,1824,2355,0.775,883,2090,2973,1780,609,402,1400,2074,7726,94.2
166,27.0,Cleveland Cavaliers*,82,19930,2756,6255,0.441,398,1033,0.385,2358,5222,0.452,1507,1982,0.76,1045,2237,3282,1672,630,349,1176,1694,7417,90.5
167,,League Average,82,19837,3115,6682,0.466,450,1255,0.359,2665,5427,0.491,1635,2220,0.737,1070,2338,3408,1916,679,423,1308,1924,8315,101.4
168,1.0,Chicago Bulls*,82,19730,3293,6892,0.478,544,1349,0.40299999999999997,2749,5543,0.496,1495,2004,0.746,1247,2411,3658,2033,745,345,1175,1807,8625,105.2
169,2.0,Orlando Magic*,82,19855,3203,6640,0.48200000000000004,622,1645,0.37799999999999995,2581,4995,0.517,1543,2232,0.691,966,2401,3367,2080,663,406,1160,1709,8571,104.5
170,3.0,Seattle SuperSonics*,82,19880,3074,6401,0.48,581,1596,0.364,2493,4805,0.519,1843,2424,0.76,954,2449,3403,1999,882,393,1441,1967,8572,104.5
171,4.0,Phoenix Suns*,82,19955,3159,6673,0.473,327,984,0.332,2832,5689,0.498,1907,2472,0.7709999999999999,1009,2501,3510,2001,623,331,1207,1776,8552,104.3
172,5.0,Boston Celtics,82,19905,3163,6942,0.456,539,1453,0.371,2624,5489,0.478,1630,2284,0.7140000000000001,1050,2427,3477,1792,653,406,1302,2041,8495,103.6
173,6.0,San Antonio Spurs*,82,19780,3148,6602,0.47700000000000004,518,1320,0.392,2630,5282,0.498,1663,2261,0.736,937,2586,3523,2044,645,536,1195,1820,8477,103.4
174,7.0,Los Angeles Lakers*,82,19680,3216,6706,0.48,477,1359,0.35100000000000003,2739,5347,0.512,1529,2049,0.746,995,2303,3298,2080,722,516,1163,1702,8438,102.9
175,8.0,Charlotte Hornets,82,19880,3108,6618,0.47,584,1520,0.384,2524,5098,0.495,1631,2119,0.77,987,2256,3243,1907,582,277,1241,1815,8431,102.8
176,9.0,Houston Rockets*,82,19805,3078,6638,0.46399999999999997,637,1761,0.36200000000000004,2441,4877,0.501,1611,2106,0.765,919,2455,3374,1982,645,476,1245,1753,8404,102.5
177,10.0,Washington Bullets,82,19805,3202,6618,0.484,493,1212,0.40700000000000003,2709,5406,0.501,1511,2076,0.728,930,2327,3257,1815,592,506,1327,1981,8408,102.5
178,11.0,Dallas Mavericks,82,19930,3124,7431,0.42,735,2039,0.36,2389,5392,0.44299999999999995,1426,1975,0.722,1408,2379,3787,1913,642,342,1270,1836,8409,102.5
179,12.0,Utah Jazz*,82,19780,3129,6417,0.488,377,1013,0.37200000000000005,2752,5404,0.509,1769,2302,0.768,993,2373,3366,2139,667,418,1215,2046,8404,102.5
180,13.0,Golden State Warriors,82,19755,3056,6700,0.456,447,1199,0.373,2609,5501,0.474,1775,2340,0.759,1173,2285,3458,1889,706,470,1343,1835,8334,101.6
181,14.0,Sacramento Kings*,82,19755,2971,6494,0.457,462,1194,0.387,2509,5300,0.473,1759,2407,0.731,1114,2345,3459,1829,643,436,1442,2131,8163,99.5
182,15.0,Los Angeles Clippers,82,19730,3126,6618,0.47200000000000003,509,1374,0.37,2617,5244,0.499,1392,1984,0.7020000000000001,979,2190,3169,1672,703,411,1355,2008,8153,99.4
183,16.0,Indiana Pacers*,82,19755,2979,6205,0.48,363,973,0.373,2616,5232,0.5,1823,2416,0.755,1010,2262,3272,1917,579,323,1335,2031,8144,99.3
184,17.0,Portland Trail Blazers*,82,19905,3064,6688,0.45799999999999996,480,1358,0.353,2584,5330,0.485,1537,2321,0.662,1160,2577,3737,1760,594,417,1377,1859,8145,99.3
185,18.0,Atlanta Hawks*,82,19730,2985,6665,0.44799999999999995,566,1595,0.355,2419,5070,0.47700000000000004,1523,2012,0.757,1182,2148,3330,1609,771,319,1228,1714,8059,98.3
186,19.0,Minnesota Timberwolves,82,19780,2974,6481,0.45899999999999996,279,857,0.326,2695,5624,0.479,1797,2314,0.777,985,2271,3256,1867,650,481,1426,1994,8024,97.9
187,20.0,Denver Nuggets,82,19830,3001,6657,0.451,397,1148,0.34600000000000003,2604,5509,0.473,1614,2173,0.743,1057,2487,3544,1851,521,597,1265,1882,8013,97.7
188,21.0,Toronto Raptors,82,19830,3084,6598,0.467,414,1168,0.354,2670,5430,0.49200000000000005,1412,1953,0.723,1071,2213,3284,1927,745,493,1544,1987,7994,97.5
189,22.0,New York Knicks*,82,19830,3003,6382,0.47100000000000003,485,1285,0.377,2518,5097,0.494,1480,1954,0.757,829,2449,3278,1822,645,377,1272,1864,7971,97.2
190,23.0,Miami Heat*,82,19780,2902,6348,0.457,552,1458,0.379,2350,4890,0.48100000000000004,1553,2187,0.71,999,2495,3494,1752,574,439,1394,2158,7909,96.5
191,24.0,Milwaukee Bucks,82,19730,3034,6490,0.467,357,1056,0.33799999999999997,2677,5434,0.493,1412,1914,0.738,973,2164,3137,1755,582,307,1295,1943,7837,95.6
192,25.0,Detroit Pistons*,82,19830,2810,6122,0.45899999999999996,545,1350,0.40399999999999997,2265,4772,0.475,1657,2206,0.7509999999999999,884,2440,3324,1610,506,352,1215,1953,7822,95.4
193,26.0,Philadelphia 76ers,82,19730,2796,6418,0.436,492,1438,0.342,2304,4980,0.46299999999999997,1662,2263,0.7340000000000001,1031,2161,3192,1629,643,420,1414,1777,7746,94.5
194,27.0,New Jersey Nets,82,19905,2881,6750,0.42700000000000005,250,746,0.335,2631,6004,0.43799999999999994,1672,2244,0.745,1350,2503,3853,1752,627,571,1375,1880,7684,93.7
195,28.0,Cleveland Cavaliers*,82,19830,2761,5998,0.46,596,1582,0.377,2165,4416,0.49,1355,1775,0.763,867,2055,2922,1818,674,340,1073,1685,7473,91.1
196,29.0,Vancouver Grizzlies,82,19880,2772,6483,0.428,372,1129,0.32899999999999996,2400,5354,0.44799999999999995,1446,1998,0.7240000000000001,957,2170,3127,1706,728,333,1347,1852,7362,89.8
197,,League Average,82,19813,3038,6575,0.462,483,1316,0.36700000000000005,2555,5259,0.486,1601,2164,0.74,1035,2348,3383,1860,654,415,1298,1890,8159,99.5
198,1.0,Chicago Bulls*,82,19730,3277,6923,0.473,523,1403,0.373,2754,5520,0.499,1381,1848,0.747,1235,2461,3696,2142,716,332,1109,1617,8458,103.1
199,2.0,Utah Jazz*,82,19830,3131,6217,0.504,334,902,0.37,2797,5315,0.526,1858,2416,0.769,889,2410,3299,2199,748,418,1259,1981,8454,103.1
200,3.0,Phoenix Suns*,82,19855,3143,6705,0.469,527,1428,0.369,2616,5277,0.496,1618,2125,0.7609999999999999,916,2376,3292,2067,664,322,1180,1727,8431,102.8
201,4.0,Seattle SuperSonics*,82,19780,2995,6415,0.467,559,1583,0.353,2436,4832,0.504,1725,2295,0.752,1010,2271,3281,1931,904,388,1231,1803,8274,100.9
202,5.0,Houston Rockets*,82,19855,3037,6484,0.46799999999999997,671,1839,0.365,2366,4645,0.509,1503,1992,0.755,927,2565,3492,2013,685,347,1365,1610,8248,100.6
203,6.0,Boston Celtics,82,19905,3066,6967,0.44,467,1331,0.35100000000000003,2599,5636,0.461,1649,2199,0.75,1095,2188,3283,1792,810,315,1342,1915,8248,100.6
204,7.0,Philadelphia 76ers,82,19780,3003,6850,0.43799999999999994,433,1356,0.319,2570,5494,0.46799999999999997,1776,2450,0.725,1267,2355,3622,1695,683,394,1437,1733,8215,100.2
205,8.0,Los Angeles Lakers*,82,19930,3018,6642,0.45399999999999996,551,1500,0.36700000000000005,2467,5142,0.48,1613,2330,0.6920000000000001,1092,2414,3506,1845,740,575,1222,1818,8200,100.0
206,9.0,Golden State Warriors,82,19905,2997,6567,0.456,481,1363,0.353,2516,5204,0.483,1696,2180,0.778,1086,2259,3345,1822,611,359,1410,1787,8171,99.6
207,10.0,Washington Bullets*,82,19855,3208,6678,0.48,331,1001,0.331,2877,5677,0.507,1400,1979,0.7070000000000001,1010,2420,3430,1921,712,402,1289,1815,8147,99.4
208,11.0,Portland Trail Blazers*,82,19855,3000,6465,0.46399999999999997,501,1401,0.358,2499,5064,0.493,1613,2261,0.713,1058,2494,3552,1710,640,435,1357,1928,8114,99.0
209,12.0,Charlotte Hornets*,82,19805,2988,6342,0.47100000000000003,591,1382,0.428,2397,4960,0.483,1541,1984,0.777,910,2298,3208,2021,597,349,1203,1702,8108,98.9
210,13.0,Denver Nuggets,82,19930,2934,6687,0.439,636,1711,0.37200000000000005,2298,4976,0.462,1516,1992,0.7609999999999999,994,2452,3446,1889,503,487,1359,1784,8020,97.8
211,14.0,Los Angeles Clippers*,82,19930,2989,6696,0.446,474,1339,0.354,2515,5357,0.469,1517,2074,0.731,1092,2242,3334,1662,733,441,1311,1964,7969,97.2
212,15.0,New Jersey Nets,82,19780,2994,7091,0.42200000000000004,484,1371,0.353,2510,5720,0.439,1502,2031,0.74,1410,2376,3786,1726,677,481,1290,1865,7974,97.2
213,16.0,Sacramento Kings,82,19855,3000,6611,0.45399999999999996,414,1058,0.391,2586,5553,0.466,1494,2067,0.723,1100,2307,3407,1799,588,362,1332,1946,7908,96.4
214,17.0,Minnesota Timberwolves*,82,19780,2937,6436,0.456,371,1093,0.33899999999999997,2566,5343,0.48,1637,2180,0.7509999999999999,957,2302,3259,1874,618,557,1243,1818,7882,96.1
215,18.0,Toronto Raptors,82,19830,2897,6632,0.43700000000000006,589,1624,0.363,2308,5008,0.461,1446,2008,0.72,1135,2254,3389,1714,722,517,1347,1883,7829,95.5
216,19.0,New York Knicks*,82,19855,2882,6227,0.46299999999999997,470,1294,0.363,2412,4933,0.489,1585,2119,0.748,973,2516,3489,1809,629,378,1462,2033,7819,95.4
217,20.0,Indiana Pacers,82,19930,2851,6254,0.456,430,1130,0.381,2421,5124,0.47200000000000003,1687,2336,0.722,1029,2390,3419,1750,585,394,1338,1977,7819,95.4
218,21.0,Milwaukee Bucks,82,19730,2967,6303,0.47100000000000003,324,920,0.35200000000000004,2643,5383,0.491,1560,2104,0.741,955,2263,3218,1610,632,348,1285,1892,7818,95.3
219,22.0,Miami Heat*,82,19805,2822,6235,0.45299999999999996,678,1865,0.364,2144,4370,0.491,1454,2022,0.7190000000000001,957,2402,3359,1735,650,439,1306,1919,7776,94.8
220,23.0,Atlanta Hawks*,82,19805,2812,6307,0.446,659,1834,0.359,2153,4473,0.48100000000000004,1491,1955,0.763,1021,2350,3371,1557,701,427,1228,1591,7774,94.8
221,24.0,Detroit Pistons*,82,19830,2827,6095,0.46399999999999997,582,1499,0.38799999999999996,2245,4596,0.488,1487,1995,0.745,858,2292,3150,1554,632,283,1041,1652,7723,94.2
222,25.0,Orlando Magic*,82,19855,2839,6497,0.43700000000000006,567,1662,0.341,2272,4835,0.47,1474,1975,0.746,1071,2221,3292,1689,694,363,1250,1643,7719,94.1
223,26.0,Dallas Mavericks,82,19805,2813,6452,0.436,430,1316,0.327,2383,5136,0.46399999999999997,1375,1918,0.7170000000000001,1040,2262,3302,1663,654,351,1324,1798,7431,90.6
224,27.0,San Antonio Spurs,82,19730,2827,6391,0.442,378,1180,0.32,2449,5211,0.47,1386,1929,0.7190000000000001,1101,2129,3230,1661,646,431,1243,1764,7418,90.5
225,28.0,Vancouver Grizzlies,82,19780,2819,6453,0.43700000000000006,445,1274,0.349,2374,5179,0.45799999999999996,1230,1734,0.7090000000000001,1023,2155,3178,1862,657,464,1301,1755,7313,89.2
226,29.0,Cleveland Cavaliers,82,19855,2704,5972,0.45299999999999996,483,1284,0.376,2221,4688,0.474,1282,1773,0.723,909,2159,3068,1714,655,315,1188,1882,7173,87.5
227,,League Average,82,19833,2958,6503,0.455,496,1377,0.36,2462,5126,0.48,1534,2078,0.738,1039,2330,3369,1808,672,403,1285,1814,7946,96.9
228,1.0,Los Angeles Lakers*,82,19830,3146,6536,0.48100000000000004,497,1415,0.35100000000000003,2649,5121,0.517,1863,2743,0.679,1079,2471,3550,2009,734,556,1256,1859,8652,105.5
229,2.0,Minnesota Timberwolves*,82,19930,3157,6844,0.461,303,873,0.34700000000000003,2854,5971,0.478,1673,2253,0.743,1063,2429,3492,2068,639,427,1138,1882,8290,101.1
230,3.0,Utah Jazz*,82,19780,2993,6113,0.49,249,670,0.37200000000000005,2744,5443,0.504,2044,2644,0.773,962,2405,3367,2070,648,412,1260,1961,8279,101.0
231,4.0,Seattle SuperSonics*,82,19755,3052,6458,0.473,621,1569,0.396,2431,4889,0.49700000000000005,1521,2109,0.721,931,2225,3156,1986,804,376,1145,1812,8246,100.6
232,5.0,New Jersey Nets*,82,19880,3055,6928,0.441,310,937,0.331,2745,5991,0.45799999999999996,1750,2351,0.7440000000000001,1344,2137,3481,1685,777,314,1180,1917,8170,99.6
233,6.0,Phoenix Suns*,82,19955,3138,6710,0.46799999999999997,431,1211,0.35600000000000004,2707,5499,0.49200000000000005,1459,1948,0.7490000000000001,991,2452,3443,2124,756,429,1236,1765,8166,99.6
234,7.0,Houston Rockets*,82,19830,2946,6513,0.452,573,1670,0.34299999999999997,2373,4843,0.49,1634,2120,0.7709999999999999,987,2350,3337,1799,686,294,1298,1653,8099,98.8
235,8.0,Washington Wizards,82,19805,3080,6811,0.452,320,944,0.33899999999999997,2760,5867,0.47,1489,2156,0.691,1121,2341,3462,1900,689,379,1156,1839,7969,97.2
236,9.0,Chicago Bulls*,82,19855,3064,6801,0.451,311,962,0.32299999999999995,2753,5839,0.47100000000000003,1492,2009,0.743,1243,2438,3681,1952,696,353,1178,1691,7931,96.7
237,10.0,Charlotte Hornets*,82,19780,2968,6344,0.46799999999999997,346,904,0.38299999999999995,2622,5440,0.48200000000000004,1641,2186,0.7509999999999999,985,2341,3326,1941,691,312,1247,1757,7923,96.6
238,11.0,Vancouver Grizzlies,82,19830,3006,6567,0.45799999999999996,325,898,0.36200000000000004,2681,5669,0.473,1586,2145,0.7390000000000001,1081,2313,3394,1960,614,349,1405,1809,7923,96.6
239,12.0,Indiana Pacers*,82,19830,2921,6223,0.469,401,1029,0.39,2520,5194,0.485,1631,2136,0.764,874,2348,3222,1889,645,368,1168,1859,7874,96.0
240,13.0,Atlanta Hawks*,82,19880,2887,6352,0.455,337,1016,0.332,2550,5336,0.478,1749,2314,0.7559999999999999,1106,2417,3523,1569,653,491,1214,1671,7860,95.9
241,14.0,Los Angeles Clippers,82,19780,2930,6690,0.43799999999999994,525,1468,0.358,2405,5222,0.461,1480,2047,0.723,1040,2276,3316,1533,625,456,1323,1827,7865,95.9
242,15.0,Boston Celtics,82,19730,3012,6934,0.434,415,1249,0.332,2597,5685,0.457,1425,1964,0.726,1196,2044,3240,1816,987,366,1330,2203,7864,95.9
243,16.0,Miami Heat*,82,19755,2850,6327,0.45,548,1544,0.355,2302,4783,0.48100000000000004,1539,2082,0.7390000000000001,1028,2419,3447,1758,665,429,1226,1982,7787,95.0
244,17.0,Toronto Raptors,82,19930,2965,6813,0.435,372,1086,0.34299999999999997,2593,5727,0.45299999999999996,1479,2060,0.718,1187,2149,3336,1746,769,663,1371,1851,7781,94.9
245,18.0,Milwaukee Bucks,82,19930,2918,6399,0.456,249,703,0.354,2669,5696,0.469,1663,2167,0.767,1035,2236,3271,1649,733,357,1383,1915,7748,94.5
246,19.0,Portland Trail Blazers*,82,19830,2885,6397,0.451,324,1047,0.309,2561,5350,0.479,1640,2226,0.737,1086,2522,3608,1766,585,464,1383,1859,7734,94.3
247,20.0,Detroit Pistons,82,19955,2862,6373,0.449,293,938,0.312,2569,5435,0.473,1704,2288,0.745,1044,2338,3382,1597,678,344,1198,1805,7721,94.2
248,21.0,Philadelphia 76ers,82,19755,2837,6409,0.44299999999999995,243,810,0.3,2594,5599,0.46299999999999997,1734,2352,0.737,1125,2294,3419,1729,729,490,1354,1878,7651,93.3
249,22.0,Sacramento Kings,82,19730,2957,6684,0.442,283,806,0.35100000000000003,2674,5878,0.455,1440,2096,0.687,1094,2304,3398,1836,596,420,1271,1810,7637,93.1
250,23.0,Cleveland Cavaliers*,82,19830,2817,6207,0.45399999999999996,298,801,0.37200000000000005,2519,5406,0.466,1653,2187,0.7559999999999999,955,2331,3286,1894,814,419,1418,1939,7585,92.5
251,24.0,San Antonio Spurs*,82,19830,2898,6187,0.46799999999999997,302,863,0.35,2596,5324,0.488,1489,2164,0.688,984,2638,3622,1839,516,568,1318,1731,7587,92.5
252,25.0,New York Knicks*,82,19830,2864,6413,0.447,382,1139,0.335,2482,5274,0.47100000000000003,1399,1812,0.772,978,2434,3412,1787,634,278,1247,1947,7509,91.6
253,26.0,Dallas Mavericks,82,19905,2882,6754,0.42700000000000005,422,1183,0.35700000000000004,2460,5571,0.442,1308,1738,0.753,1008,2280,3288,1535,646,466,1182,1643,7494,91.4
254,27.0,Orlando Magic,82,19830,2771,6455,0.429,293,907,0.32299999999999995,2478,5548,0.447,1552,2138,0.726,1178,2203,3381,1694,649,441,1258,1617,7387,90.1
255,28.0,Denver Nuggets,82,19730,2677,6412,0.41700000000000004,288,893,0.32299999999999995,2389,5519,0.433,1658,2147,0.772,1040,2157,3197,1547,664,393,1311,1937,7300,89.0
256,29.0,Golden State Warriors,82,19830,2845,6883,0.413,189,696,0.272,2656,6187,0.429,1358,1912,0.71,1288,2473,3761,1708,621,448,1369,1859,7237,88.3
257,,League Average,82,19832,2944,6536,0.45,360,1042,0.34600000000000003,2584,5493,0.47,1588,2155,0.737,1070,2337,3407,1806,688,416,1270,1837,7837,95.6
258,1.0,Sacramento Kings*,50,12200,1918,4307,0.445,290,943,0.308,1628,3364,0.484,883,1293,0.6829999999999999,706,1573,2279,1129,444,232,842,1016,5009,100.2
259,2.0,Los Angeles Lakers*,50,12050,1841,3935,0.46799999999999997,241,685,0.35200000000000004,1600,3250,0.49200000000000005,1027,1503,0.6829999999999999,619,1482,2101,1095,389,287,754,1231,4950,99.0
260,3.0,Phoenix Suns*,50,12050,1797,4004,0.449,261,702,0.37200000000000005,1536,3302,0.465,924,1215,0.76,598,1418,2016,1249,444,200,681,1022,4779,95.6
261,4.0,Seattle SuperSonics,50,12100,1756,3976,0.442,309,899,0.344,1447,3077,0.47,922,1354,0.6809999999999999,676,1422,2098,1087,393,201,765,1047,4743,94.9
262,5.0,Portland Trail Blazers*,50,12175,1747,3956,0.442,246,675,0.364,1501,3281,0.457,1002,1349,0.743,646,1570,2216,1073,411,290,771,1126,4742,94.8
263,6.0,Indiana Pacers*,50,12100,1731,3866,0.44799999999999995,294,799,0.368,1437,3067,0.469,977,1228,0.7959999999999999,574,1452,2026,1005,316,223,649,1082,4733,94.7
264,7.0,Houston Rockets*,50,12075,1755,3798,0.462,336,914,0.368,1419,2884,0.49200000000000005,865,1187,0.7290000000000001,536,1540,2076,1058,386,260,812,960,4711,94.2
265,8.0,Denver Nuggets,50,12025,1681,3989,0.42100000000000004,302,922,0.32799999999999996,1379,3067,0.45,1010,1325,0.762,647,1392,2039,969,376,275,739,1145,4674,93.5
266,9.0,Utah Jazz*,50,12175,1684,3620,0.465,140,388,0.361,1544,3232,0.478,1158,1510,0.767,555,1508,2063,1204,398,276,814,1133,4666,93.3
267,10.0,Boston Celtics,50,12150,1816,4164,0.436,273,758,0.36,1543,3406,0.45299999999999996,745,1077,0.6920000000000001,680,1458,2138,1073,453,255,807,1193,4650,93.0
268,11.0,Minnesota Timberwolves*,50,12025,1838,4327,0.425,122,410,0.298,1716,3917,0.43799999999999994,849,1143,0.743,754,1392,2146,1218,426,272,641,1185,4647,92.9
269,12.0,Charlotte Hornets,50,12150,1671,3718,0.449,268,735,0.365,1403,2983,0.47,1034,1384,0.747,480,1493,1973,1110,443,247,796,1101,4644,92.9
270,13.0,San Antonio Spurs*,50,12075,1740,3812,0.456,172,521,0.33,1568,3291,0.47600000000000003,988,1415,0.698,614,1584,2198,1101,421,351,759,1010,4640,92.8
271,14.0,Milwaukee Bucks*,50,12050,1753,3818,0.45899999999999996,231,619,0.373,1522,3199,0.47600000000000003,847,1155,0.733,570,1369,1939,1030,442,202,719,1142,4584,91.7
272,15.0,Dallas Mavericks,50,12075,1749,4033,0.434,202,595,0.33899999999999997,1547,3438,0.45,881,1210,0.728,645,1478,2123,921,352,292,692,1065,4581,91.6
273,16.0,New Jersey Nets,50,12050,1691,4160,0.406,225,679,0.331,1466,3481,0.42100000000000004,962,1251,0.769,715,1437,2152,923,491,273,750,1134,4569,91.4
274,17.0,Washington Wizards,50,12050,1768,3969,0.445,179,580,0.309,1589,3389,0.469,845,1198,0.705,595,1403,1998,1064,393,193,736,1151,4560,91.2
275,18.0,Toronto Raptors,50,12075,1660,3940,0.42100000000000004,226,662,0.341,1434,3278,0.43700000000000006,1011,1330,0.76,712,1447,2159,1036,439,321,799,1139,4557,91.1
276,19.0,Los Angeles Clippers,50,12125,1711,4007,0.42700000000000005,214,668,0.32,1497,3339,0.44799999999999995,883,1225,0.721,665,1293,1958,820,424,236,796,1223,4519,90.4
277,20.0,Detroit Pistons*,50,12050,1660,3716,0.447,248,679,0.365,1412,3037,0.465,950,1283,0.74,605,1412,2017,1009,444,208,790,1139,4518,90.4
278,21.0,Philadelphia 76ers*,50,12150,1656,3883,0.426,98,371,0.264,1558,3512,0.444,1073,1486,0.722,729,1428,2157,934,542,271,822,1152,4483,89.7
279,22.0,Orlando Magic*,50,12050,1687,3943,0.428,223,675,0.33,1464,3268,0.44799999999999995,876,1252,0.7,688,1445,2133,1067,496,213,819,935,4473,89.5
280,23.0,Miami Heat*,50,12025,1616,3565,0.45299999999999996,289,804,0.359,1327,2761,0.48100000000000004,928,1262,0.735,503,1512,2015,1019,327,304,744,1035,4449,89.0
281,24.0,Vancouver Grizzlies,50,12175,1643,3838,0.428,148,453,0.327,1495,3385,0.442,1009,1408,0.7170000000000001,650,1359,2009,964,420,199,848,1123,4443,88.9
282,25.0,Golden State Warriors,50,12125,1730,4173,0.415,162,565,0.287,1568,3608,0.435,794,1175,0.6759999999999999,816,1559,2375,1037,414,221,768,1270,4416,88.3
283,26.0,Cleveland Cavaliers,50,12050,1562,3561,0.439,182,534,0.341,1380,3027,0.456,1016,1356,0.7490000000000001,472,1316,1788,1093,452,203,785,1208,4322,86.4
284,27.0,New York Knicks*,50,12100,1610,3704,0.435,208,589,0.353,1402,3115,0.45,892,1218,0.732,551,1510,2061,963,395,262,804,1140,4320,86.4
285,28.0,Atlanta Hawks*,50,12075,1539,3760,0.409,197,644,0.306,1342,3116,0.431,1040,1422,0.731,676,1499,2175,782,346,260,745,987,4315,86.3
286,29.0,Chicago Bulls,50,12075,1539,3837,0.401,177,612,0.289,1362,3225,0.42200000000000004,840,1185,0.7090000000000001,573,1394,1967,1017,436,169,774,1112,4095,81.9
287,,League Average,50,12091,1709,3910,0.43700000000000006,223,658,0.33899999999999997,1486,3252,0.457,939,1290,0.728,629,1453,2083,1036,418,248,766,1111,4579,91.6
288,1.0,Sacramento Kings*,82,19805,3276,7288,0.45,534,1656,0.322,2742,5632,0.48700000000000004,1521,2016,0.754,1056,2635,3691,1953,787,381,1325,1729,8607,105.0
289,2.0,Detroit Pistons*,82,19830,3044,6635,0.45899999999999996,439,1223,0.359,2605,5412,0.48100000000000004,1956,2506,0.7809999999999999,917,2458,3375,1707,665,273,1288,2011,8483,103.5
290,3.0,Dallas Mavericks,82,19730,3195,7047,0.45299999999999996,519,1326,0.391,2676,5721,0.46799999999999997,1407,1751,0.804,931,2444,3375,1810,592,416,1124,1770,8316,101.4
291,4.0,Indiana Pacers*,82,19730,3047,6640,0.45899999999999996,583,1487,0.392,2464,5153,0.478,1629,2008,0.8109999999999999,842,2612,3454,1857,559,422,1159,1786,8306,101.3
292,5.0,Milwaukee Bucks*,82,19855,3174,6827,0.465,394,1069,0.369,2780,5758,0.483,1558,1982,0.7859999999999999,1016,2373,3389,1852,671,381,1230,2020,8300,101.2
293,6.0,Los Angeles Lakers*,82,19805,3137,6836,0.45899999999999996,344,1047,0.32899999999999996,2793,5789,0.48200000000000004,1649,2368,0.696,1117,2738,3855,1921,613,534,1143,1841,8267,100.8
294,7.0,Orlando Magic,82,19755,3169,7014,0.452,294,870,0.33799999999999997,2875,6144,0.46799999999999997,1574,2142,0.735,1145,2540,3685,1709,743,467,1443,1967,8206,100.1
295,8.0,Houston Rockets,82,19830,3001,6664,0.45,581,1625,0.358,2420,5039,0.48,1573,2145,0.733,1008,2586,3594,1774,613,438,1425,1663,8156,99.5
296,9.0,Boston Celtics,82,19730,3054,6880,0.444,417,1260,0.331,2637,5620,0.469,1621,2175,0.745,1108,2420,3528,1741,795,286,1259,2223,8146,99.3
297,10.0,Seattle SuperSonics*,82,19780,3108,6946,0.447,546,1611,0.33899999999999997,2562,5335,0.48,1363,1960,0.695,1042,2483,3525,1878,657,345,1152,1776,8125,99.1
298,11.0,Denver Nuggets,82,19855,3057,6911,0.442,470,1397,0.336,2587,5514,0.469,1531,2116,0.7240000000000001,1073,2590,3663,1911,554,618,1281,1962,8115,99.0
299,12.0,Phoenix Suns*,82,19805,3093,6771,0.457,458,1246,0.368,2635,5525,0.47700000000000004,1467,1934,0.759,1022,2558,3580,2098,744,433,1368,1973,8111,98.9
300,13.0,Minnesota Timberwolves*,82,19905,3226,6910,0.467,248,716,0.34600000000000003,2978,6194,0.48100000000000004,1379,1769,0.78,1016,2471,3487,2205,622,444,1139,1913,8079,98.5
301,14.0,Charlotte Hornets*,82,19780,2935,6533,0.449,339,1001,0.33899999999999997,2596,5532,0.469,1863,2458,0.758,884,2635,3519,2023,732,480,1206,1670,8072,98.4
302,15.0,New Jersey Nets,82,19830,2979,6881,0.433,477,1374,0.34700000000000003,2502,5507,0.45399999999999996,1601,2041,0.784,1040,2315,3355,1688,720,393,1119,1913,8036,98.0
303,16.0,Portland Trail Blazers*,82,19780,3021,6430,0.47,407,1128,0.361,2614,5302,0.493,1542,2029,0.76,966,2560,3526,1925,633,396,1243,1865,7991,97.5
304,17.0,Toronto Raptors*,82,19755,2980,6882,0.433,425,1171,0.363,2555,5711,0.447,1583,2068,0.765,1098,2449,3547,1947,666,544,1137,1989,7968,97.2
305,18.0,Cleveland Cavaliers,82,19855,2977,6734,0.442,343,919,0.373,2634,5815,0.45299999999999996,1653,2205,0.75,1010,2499,3509,1941,715,363,1427,2219,7950,97.0
306,19.0,Washington Wizards,82,19805,3010,6681,0.451,335,890,0.376,2675,5791,0.462,1566,2107,0.743,1064,2438,3502,1771,593,383,1320,2149,7921,96.6
307,20.0,Utah Jazz*,82,19755,2962,6380,0.46399999999999997,329,854,0.385,2633,5526,0.47600000000000003,1661,2150,0.773,936,2426,3362,2041,629,446,1220,2013,7914,96.5
308,21.0,San Antonio Spurs*,82,19855,2952,6393,0.462,330,882,0.374,2622,5511,0.47600000000000003,1652,2214,0.746,927,2666,3593,1819,614,551,1233,1716,7886,96.2
309,22.0,Golden State Warriors,82,19755,2996,7140,0.42,345,1069,0.32299999999999995,2651,6071,0.43700000000000006,1497,2147,0.6970000000000001,1300,2438,3738,1851,731,356,1302,2043,7834,95.5
310,23.0,Philadelphia 76ers*,82,19830,2993,6776,0.442,208,643,0.32299999999999995,2785,6133,0.45399999999999996,1577,2226,0.708,1147,2468,3615,1817,791,386,1284,1939,7771,94.8
311,24.0,Miami Heat*,82,19830,2974,6462,0.46,446,1202,0.371,2528,5260,0.48100000000000004,1345,1827,0.736,921,2619,3540,1931,582,524,1231,1947,7739,94.4
312,25.0,Atlanta Hawks,82,19830,3000,6807,0.441,258,814,0.317,2742,5993,0.45799999999999996,1477,1987,0.743,1146,2570,3716,1548,500,461,1266,1718,7735,94.3
313,26.0,Vancouver Grizzlies,82,19855,2892,6441,0.449,324,898,0.361,2568,5543,0.46299999999999997,1594,2060,0.774,1005,2324,3329,1700,608,346,1381,1881,7702,93.9
314,27.0,New York Knicks*,82,19830,2897,6374,0.455,351,937,0.375,2546,5437,0.46799999999999997,1410,1805,0.7809999999999999,802,2521,3323,1588,515,349,1201,1983,7555,92.1
315,28.0,Los Angeles Clippers,82,19705,2877,6757,0.426,429,1267,0.33899999999999997,2448,5490,0.446,1363,1826,0.746,955,2377,3332,1479,578,494,1325,1821,7546,92.0
316,29.0,Chicago Bulls,82,19805,2565,6180,0.415,340,1032,0.32899999999999996,2225,5148,0.43200000000000005,1482,2089,0.7090000000000001,1032,2323,3355,1645,646,383,1557,1908,6952,84.8
317,,League Average,82,19802,3020,6732,0.449,397,1125,0.353,2623,5607,0.46799999999999997,1555,2073,0.75,1018,2501,3519,1832,651,424,1269,1911,7993,97.5
318,1.0,Sacramento Kings*,82,20080,3132,6969,0.449,479,1353,0.354,2653,5616,0.47200000000000003,1600,2075,0.7709999999999999,987,2705,3692,1852,793,432,1221,1596,8343,101.7
319,2.0,Milwaukee Bucks*,82,19780,3112,6798,0.45799999999999996,562,1481,0.379,2550,5317,0.48,1474,1874,0.787,975,2500,3475,1844,672,386,1123,1928,8260,100.7
320,3.0,Los Angeles Lakers*,82,19905,3109,6685,0.465,439,1275,0.344,2670,5410,0.494,1594,2333,0.6829999999999999,1085,2583,3668,1888,564,490,1184,1872,8251,100.6
321,4.0,Dallas Mavericks*,82,19805,3085,6716,0.45899999999999996,517,1357,0.381,2568,5359,0.479,1552,1954,0.794,831,2571,3402,1740,618,492,1141,1907,8239,100.5
322,5.0,Toronto Raptors*,82,19955,3048,6972,0.43700000000000006,429,1164,0.369,2619,5808,0.451,1482,1984,0.747,1118,2529,3647,2004,599,519,1080,1745,8007,97.6
323,6.0,Orlando Magic*,82,19955,3013,6873,0.43799999999999994,490,1346,0.364,2523,5527,0.456,1476,2068,0.7140000000000001,1069,2450,3519,1803,674,481,1245,2071,7992,97.5
324,7.0,Minnesota Timberwolves*,82,19830,3148,6871,0.45799999999999996,322,901,0.35700000000000004,2826,5970,0.473,1364,1737,0.785,1002,2470,3472,2083,682,456,1136,1900,7982,97.3
325,8.0,Seattle SuperSonics,82,19805,3029,6649,0.456,466,1169,0.39899999999999997,2563,5480,0.46799999999999997,1454,1986,0.732,999,2422,3421,1792,657,409,1252,1733,7978,97.3
326,9.0,Houston Rockets,82,19830,2943,6494,0.45299999999999996,504,1412,0.35700000000000004,2439,5082,0.48,1582,2086,0.758,919,2524,3443,1613,587,358,1204,1657,7972,97.2
327,10.0,Utah Jazz*,82,19780,2960,6289,0.47100000000000003,325,852,0.381,2635,5437,0.485,1714,2280,0.752,943,2383,3326,2110,661,463,1296,2107,7959,97.1
328,11.0,Denver Nuggets,82,19780,2979,6877,0.433,512,1444,0.355,2467,5433,0.45399999999999996,1448,1964,0.737,1044,2583,3627,1970,552,538,1136,1820,7918,96.6
329,12.0,San Antonio Spurs*,82,19830,2884,6262,0.461,445,1094,0.40700000000000003,2439,5168,0.47200000000000003,1673,2340,0.715,902,2712,3614,1778,568,576,1145,1551,7886,96.2
330,13.0,Detroit Pistons,82,19855,2919,6880,0.424,389,1112,0.35,2530,5768,0.439,1610,2233,0.721,1108,2626,3734,1629,613,447,1304,1955,7837,95.6
331,14.0,Portland Trail Blazers*,82,19780,3004,6417,0.46799999999999997,369,1057,0.349,2635,5360,0.49200000000000005,1447,1899,0.762,960,2481,3441,1963,672,419,1257,1745,7824,95.4
332,15.0,Philadelphia 76ers*,82,19855,2902,6487,0.447,262,803,0.326,2640,5684,0.46399999999999997,1697,2277,0.745,1075,2600,3675,1692,690,408,1292,1673,7763,94.7
333,16.0,Boston Celtics,82,19830,2773,6485,0.428,592,1633,0.363,2181,4852,0.45,1621,2190,0.74,897,2367,3264,1708,769,336,1285,1952,7759,94.6
334,17.0,Phoenix Suns*,82,19805,2944,6757,0.436,332,1054,0.315,2612,5703,0.45799999999999996,1490,1973,0.755,970,2529,3499,1905,775,429,1250,1864,7710,94.0
335,18.0,Washington Wizards,82,19680,2833,6453,0.439,275,848,0.324,2558,5605,0.456,1704,2245,0.759,1016,2370,3386,1647,630,383,1391,1913,7645,93.2
336,19.0,Indiana Pacers*,82,19980,2828,6431,0.44,396,1159,0.342,2432,5272,0.461,1539,2009,0.7659999999999999,921,2595,3516,1763,563,487,1244,1926,7591,92.6
337,20.0,Golden State Warriors,82,19780,2937,7175,0.409,282,964,0.293,2655,6211,0.42700000000000005,1428,2024,0.706,1345,2385,3730,1788,742,410,1301,1727,7584,92.5
338,21.0,Los Angeles Clippers,82,20030,2896,6467,0.44799999999999995,360,1063,0.33899999999999997,2536,5404,0.469,1429,2061,0.693,962,2559,3521,1585,490,513,1293,1775,7581,92.5
339,22.0,Cleveland Cavaliers,82,19830,2890,6532,0.442,220,659,0.33399999999999996,2670,5873,0.455,1561,2040,0.765,1015,2440,3455,1708,642,436,1350,1904,7561,92.2
340,23.0,New Jersey Nets,82,19730,2781,6550,0.425,361,1084,0.33299999999999996,2420,5466,0.44299999999999995,1629,2146,0.759,909,2337,3246,1603,649,407,1208,1982,7552,92.1
341,24.0,Charlotte Hornets*,82,19880,2800,6501,0.431,340,984,0.34600000000000003,2460,5517,0.446,1599,2146,0.745,1033,2608,3641,1900,665,455,1183,1753,7539,91.9
342,25.0,Vancouver Grizzlies,82,19780,2870,6539,0.439,325,947,0.34299999999999997,2545,5592,0.455,1457,1892,0.77,894,2431,3325,1899,586,359,1291,1733,7522,91.7
343,26.0,Atlanta Hawks,82,19730,2876,6668,0.431,333,933,0.35700000000000004,2543,5735,0.44299999999999995,1374,1811,0.759,1028,2490,3518,1559,634,387,1368,1863,7459,91.0
344,27.0,Miami Heat*,82,19880,2694,6258,0.43,478,1384,0.345,2216,4874,0.455,1423,1874,0.759,813,2435,3248,1630,633,304,1122,1726,7289,88.9
345,28.0,New York Knicks*,82,19905,2755,6198,0.444,391,1115,0.35100000000000003,2364,5083,0.465,1374,1727,0.7959999999999999,773,2524,3297,1520,545,346,1189,1863,7275,88.7
346,29.0,Chicago Bulls,82,19855,2721,6411,0.424,329,950,0.34600000000000003,2392,5461,0.43799999999999994,1410,1909,0.7390000000000001,926,2260,3186,1810,675,379,1292,1902,7181,87.6
347,,League Average,82,19846,2926,6609,0.44299999999999995,397,1124,0.354,2529,5485,0.461,1524,2039,0.748,983,2499,3482,1786,641,431,1234,1833,7774,94.8
348,1.0,Dallas Mavericks*,82,19880,3200,6930,0.462,621,1645,0.37799999999999995,2579,5285,0.488,1608,1994,0.8059999999999999,918,2568,3486,1811,581,392,992,1842,8629,105.2
349,2.0,Sacramento Kings*,82,19755,3267,7003,0.467,426,1160,0.36700000000000005,2841,5843,0.486,1618,2154,0.7509999999999999,1013,2702,3715,1958,741,375,1128,1560,8578,104.6
350,3.0,Los Angeles Lakers*,82,19780,3150,6840,0.461,510,1439,0.354,2640,5401,0.489,1494,2138,0.6990000000000001,1022,2607,3629,1882,625,478,1040,1823,8304,101.3
351,4.0,Orlando Magic*,82,19830,3087,6893,0.44799999999999995,620,1660,0.373,2467,5233,0.47100000000000003,1446,1917,0.754,942,2440,3382,1804,665,384,1119,1700,8240,100.5
352,5.0,Minnesota Timberwolves*,82,19805,3175,6887,0.461,396,1047,0.37799999999999995,2779,5840,0.47600000000000003,1399,1754,0.7979999999999999,1059,2562,3621,1993,524,427,1097,1739,8145,99.3
353,6.0,Seattle SuperSonics*,82,19830,3131,6681,0.469,489,1292,0.37799999999999995,2642,5389,0.49,1263,1672,0.755,968,2333,3301,1926,698,364,1124,1732,8014,97.7
354,7.0,Golden State Warriors,82,19780,2998,6989,0.429,320,994,0.322,2678,5995,0.447,1693,2344,0.722,1334,2493,3827,1706,650,523,1378,1884,8009,97.7
355,8.0,Milwaukee Bucks,82,19905,3041,6577,0.462,593,1583,0.375,2448,4994,0.49,1321,1767,0.748,841,2557,3398,1847,596,388,1157,1788,7996,97.5
356,9.0,Indiana Pacers*,82,19905,2935,6580,0.446,405,1195,0.33899999999999997,2530,5385,0.47,1663,2155,0.772,930,2568,3498,1884,658,436,1249,1876,7938,96.8
357,10.0,San Antonio Spurs*,82,19855,2913,6363,0.45799999999999996,438,1211,0.36200000000000004,2475,5152,0.48,1668,2249,0.742,907,2566,3473,1643,625,537,1180,1575,7932,96.7
358,11.0,Portland Trail Blazers*,82,19830,3004,6671,0.45,466,1318,0.354,2538,5353,0.474,1451,1901,0.763,1085,2444,3529,1926,702,368,1172,1613,7925,96.6
359,12.0,Boston Celtics*,82,19830,2852,6731,0.424,699,1946,0.359,2153,4785,0.45,1498,1960,0.764,891,2570,3461,1722,793,292,1114,1776,7901,96.4
360,13.0,New Jersey Nets*,82,19830,3042,6816,0.446,403,1194,0.33799999999999997,2639,5622,0.469,1402,1907,0.735,1039,2515,3554,1990,716,490,1189,1734,7889,96.2
361,14.0,Utah Jazz*,82,19830,2869,6374,0.45,280,842,0.33299999999999996,2589,5532,0.46799999999999997,1853,2430,0.763,1109,2349,3458,1999,749,523,1353,1971,7871,96.0
362,15.0,Los Angeles Clippers,82,19805,2970,6668,0.445,408,1147,0.35600000000000004,2562,5521,0.46399999999999997,1498,2026,0.7390000000000001,1083,2474,3557,1714,510,540,1214,1624,7846,95.7
363,16.0,Cleveland Cavaliers,82,19855,2948,6582,0.44799999999999995,387,1026,0.377,2561,5556,0.461,1529,1980,0.772,968,2483,3451,1891,572,470,1196,1752,7812,95.3
364,17.0,Phoenix Suns,82,19830,3097,6934,0.447,358,1096,0.327,2739,5838,0.469,1250,1630,0.767,1072,2430,3502,1838,668,401,1205,1785,7802,95.1
365,18.0,Detroit Pistons*,82,19680,2845,6300,0.452,567,1509,0.376,2278,4791,0.475,1478,1954,0.7559999999999999,810,2366,3176,1765,648,565,1193,1695,7735,94.3
366,19.0,Atlanta Hawks,82,19780,2901,6610,0.439,423,1194,0.354,2478,5416,0.45799999999999996,1486,1942,0.765,955,2445,3400,1656,667,350,1275,1702,7711,94.0
367,20.0,Charlotte Hornets*,82,19755,2893,6580,0.44,346,994,0.348,2547,5586,0.456,1568,2105,0.745,1059,2505,3564,1759,653,456,1150,1747,7700,93.9
368,21.0,Washington Wizards,82,19730,2938,6664,0.441,305,786,0.38799999999999996,2633,5878,0.44799999999999995,1428,1866,0.765,1055,2393,3448,1715,570,354,1068,1763,7609,92.8
369,22.0,Houston Rockets,82,19980,2837,6629,0.428,496,1480,0.335,2341,5149,0.455,1402,1893,0.741,1025,2411,3436,1482,537,445,1156,1476,7572,92.3
370,23.0,Denver Nuggets,82,19805,2915,6870,0.424,423,1285,0.32899999999999996,2492,5585,0.446,1306,1756,0.7440000000000001,1117,2310,3427,1817,613,462,1205,1873,7559,92.2
371,24.0,New York Knicks,82,19805,2817,6520,0.43200000000000005,474,1344,0.353,2343,5176,0.45299999999999996,1406,1786,0.787,876,2458,3334,1720,558,288,1192,1800,7514,91.6
372,25.0,Toronto Raptors*,82,19755,2919,6727,0.434,387,1109,0.349,2532,5618,0.451,1269,1717,0.7390000000000001,1114,2336,3450,1779,688,454,1174,1771,7494,91.4
373,26.0,Philadelphia 76ers*,82,19730,2804,6436,0.436,214,715,0.299,2590,5721,0.45299999999999996,1639,2104,0.779,1092,2534,3626,1638,705,363,1256,1645,7461,91.0
374,27.0,Memphis Grizzlies,82,19780,2851,6535,0.436,336,1096,0.307,2515,5439,0.462,1334,1883,0.708,984,2413,3397,1785,646,488,1344,1571,7372,89.9
375,28.0,Chicago Bulls,82,19805,2811,6491,0.433,300,868,0.34600000000000003,2511,5623,0.447,1413,1958,0.722,924,2359,3283,1817,633,361,1252,1834,7335,89.5
376,29.0,Miami Heat,82,19930,2801,6382,0.439,312,899,0.34700000000000003,2489,5483,0.45399999999999996,1236,1708,0.7240000000000001,902,2544,3446,1664,547,448,1217,1846,7150,87.2
377,,League Average,82,19816,2966,6664,0.445,428,1209,0.354,2538,5455,0.465,1470,1953,0.752,1003,2474,3477,1798,639,428,1186,1741,7829,95.5
378,1.0,Dallas Mavericks*,82,19780,3161,6982,0.45299999999999996,636,1668,0.381,2525,5314,0.475,1486,1793,0.8290000000000001,912,2544,3456,1837,665,449,949,1730,8444,103.0
379,2.0,Golden State Warriors,82,19755,3061,6941,0.441,425,1235,0.344,2636,5706,0.462,1853,2382,0.778,1284,2546,3830,1712,594,506,1295,1786,8400,102.4
380,3.0,Sacramento Kings*,82,19830,3242,6990,0.46399999999999997,491,1288,0.381,2751,5702,0.48200000000000004,1367,1832,0.746,900,2751,3651,2034,736,457,1192,1666,8342,101.7
381,4.0,Los Angeles Lakers*,82,19930,3091,6856,0.451,486,1367,0.35600000000000004,2605,5489,0.475,1562,2129,0.7340000000000001,1078,2554,3632,1909,639,470,1192,1874,8230,100.4
382,5.0,Milwaukee Bucks*,82,19905,3045,6670,0.457,585,1526,0.38299999999999995,2460,5144,0.478,1483,1911,0.7759999999999999,876,2367,3243,1823,622,344,1044,1820,8158,99.5
383,6.0,Orlando Magic*,82,19805,2947,6763,0.436,568,1590,0.35700000000000004,2379,5173,0.46,1616,2079,0.777,958,2392,3350,1676,696,300,1177,1888,8078,98.5
384,7.0,Minnesota Timberwolves*,82,19805,3172,6809,0.466,296,804,0.368,2876,6005,0.479,1406,1826,0.77,959,2614,3573,2070,553,433,1124,1704,8046,98.1
385,8.0,Memphis Grizzlies,82,19930,3049,6743,0.452,467,1279,0.365,2582,5464,0.473,1430,1936,0.7390000000000001,943,2466,3409,1892,651,500,1262,1678,7995,97.5
386,9.0,Indiana Pacers*,82,19905,2911,6608,0.441,379,1119,0.33899999999999997,2532,5489,0.461,1739,2271,0.7659999999999999,1004,2622,3626,1910,696,443,1210,1811,7940,96.8
387,10.0,Philadelphia 76ers*,82,19855,2975,6640,0.44799999999999995,245,787,0.311,2730,5853,0.466,1746,2253,0.775,1042,2415,3457,1771,844,284,1212,1804,7941,96.8
388,11.0,New York Knicks,82,19855,2967,6725,0.441,606,1582,0.38299999999999995,2361,5143,0.45899999999999996,1320,1620,0.815,842,2376,3218,1800,579,255,1149,1888,7860,95.9
389,12.0,San Antonio Spurs*,82,19830,2908,6297,0.462,449,1270,0.354,2459,5027,0.489,1591,2194,0.725,939,2556,3495,1636,629,529,1295,1672,7856,95.8
390,13.0,Phoenix Suns*,82,19805,3005,6776,0.44299999999999995,394,1149,0.34299999999999997,2611,5627,0.46399999999999997,1430,1928,0.742,1049,2440,3489,1719,665,404,1208,1801,7834,95.5
391,14.0,New Jersey Nets*,82,19755,2906,6585,0.441,346,1041,0.332,2560,5544,0.462,1662,2195,0.757,991,2528,3519,1887,717,374,1212,1772,7820,95.4
392,15.0,Portland Trail Blazers*,82,19855,2987,6491,0.46,379,1150,0.33,2608,5341,0.488,1450,1947,0.745,992,2378,3370,1860,725,316,1248,1634,7803,95.2
393,16.0,Chicago Bulls,82,19930,2991,6714,0.445,349,997,0.35,2642,5717,0.462,1455,2014,0.722,985,2541,3526,1782,605,461,1388,2028,7786,95.0
394,17.0,Utah Jazz*,82,19780,2894,6189,0.46799999999999997,224,641,0.349,2670,5548,0.48100000000000004,1750,2349,0.745,1021,2381,3402,2103,708,467,1374,1837,7762,94.7
395,18.0,Atlanta Hawks,82,19905,2859,6434,0.444,402,1141,0.35200000000000004,2457,5293,0.46399999999999997,1594,2011,0.7929999999999999,937,2558,3495,1679,611,473,1367,1783,7714,94.1
396,19.0,New Orleans Hornets*,82,19905,2914,6695,0.435,404,1075,0.376,2510,5620,0.447,1467,1910,0.768,1097,2475,3572,1807,656,394,1212,1769,7699,93.9
397,20.0,Los Angeles Clippers,82,19755,2835,6490,0.43700000000000006,390,1178,0.331,2445,5312,0.46,1633,2177,0.75,1008,2462,3470,1605,574,461,1291,1784,7693,93.8
398,21.0,Houston Rockets,82,19930,2840,6461,0.44,439,1267,0.34600000000000003,2401,5194,0.462,1569,2044,0.768,1024,2564,3588,1506,594,493,1276,1602,7688,93.8
399,22.0,Boston Celtics*,82,19830,2700,6509,0.415,719,2155,0.33399999999999996,1981,4354,0.455,1480,1994,0.742,849,2471,3320,1575,720,303,1147,1758,7599,92.7
400,23.0,Seattle SuperSonics,82,19855,2887,6599,0.43700000000000006,456,1291,0.353,2431,5308,0.45799999999999996,1325,1780,0.7440000000000001,963,2385,3348,1775,679,295,1085,1712,7555,92.1
401,24.0,Washington Wizards,82,19830,2816,6394,0.44,253,811,0.312,2563,5583,0.45899999999999996,1617,2077,0.779,917,2395,3312,1612,621,390,1095,1644,7502,91.5
402,25.0,Cleveland Cavaliers,82,19830,2850,6746,0.42200000000000004,293,896,0.327,2557,5850,0.43700000000000006,1502,2012,0.747,1118,2542,3660,1712,636,521,1501,1864,7495,91.4
403,26.0,Detroit Pistons*,82,19905,2700,6277,0.43,533,1488,0.358,2167,4789,0.452,1559,2021,0.7709999999999999,883,2445,3328,1620,556,468,1104,1748,7492,91.4
404,27.0,Toronto Raptors,82,19805,2847,6664,0.42700000000000005,409,1193,0.34299999999999997,2438,5471,0.446,1350,1879,0.718,1023,2355,3378,1583,609,392,1181,1761,7453,90.9
405,28.0,Miami Heat,82,19830,2688,6517,0.41200000000000003,348,1100,0.316,2340,5417,0.43200000000000005,1292,1689,0.765,948,2464,3412,1501,592,324,1167,1856,7016,85.6
406,29.0,Denver Nuggets,82,19730,2689,6544,0.41100000000000003,229,824,0.278,2460,5720,0.43,1294,1850,0.6990000000000001,1112,2363,3475,1737,712,422,1514,2056,6901,84.2
407,,League Average,82,19842,2929,6624,0.442,421,1204,0.349,2508,5421,0.46299999999999997,1518,2004,0.758,988,2481,3469,1763,651,411,1223,1784,7797,95.1
408,1.0,Dallas Mavericks*,82,19805,3322,7230,0.45899999999999996,507,1456,0.348,2815,5774,0.488,1475,1854,0.7959999999999999,1174,2538,3712,1963,656,437,1000,1609,8626,105.2
409,2.0,Sacramento Kings*,82,19780,3103,6711,0.462,601,1498,0.401,2502,5213,0.48,1626,2044,0.795,888,2492,3380,2152,710,325,1137,1586,8433,102.8
410,3.0,Los Angeles Lakers*,82,19855,3028,6676,0.45399999999999996,365,1115,0.327,2663,5561,0.479,1631,2352,0.693,1001,2535,3536,1948,682,379,1132,1732,8052,98.2
411,4.0,Milwaukee Bucks*,82,19780,2970,6650,0.447,401,1145,0.35,2569,5505,0.467,1698,2192,0.775,960,2502,3462,1872,554,383,1110,1668,8039,98.0
412,5.0,Denver Nuggets*,82,19730,2993,6763,0.44299999999999995,331,985,0.336,2662,5778,0.461,1655,2159,0.767,1083,2387,3470,1794,745,520,1278,1804,7972,97.2
413,6.0,Seattle SuperSonics,82,19805,2939,6590,0.446,723,1936,0.373,2216,4654,0.47600000000000003,1363,1782,0.765,907,2318,3225,1782,661,387,1188,1784,7964,97.1
414,7.0,Memphis Grizzlies*,82,19880,2963,6657,0.445,447,1314,0.34,2516,5343,0.47100000000000003,1557,2143,0.727,1047,2381,3428,1915,795,565,1226,1903,7930,96.7
415,8.0,Boston Celtics*,82,19705,2843,6415,0.44299999999999995,553,1599,0.34600000000000003,2290,4816,0.475,1572,2095,0.75,851,2440,3291,1683,770,331,1332,1837,7811,95.3
416,9.0,Los Angeles Clippers,82,19805,2817,6579,0.428,329,1024,0.321,2488,5555,0.44799999999999995,1808,2302,0.785,1149,2416,3565,1653,594,376,1344,1816,7771,94.8
417,10.0,Minnesota Timberwolves*,82,19755,3033,6571,0.462,326,897,0.363,2707,5674,0.47700000000000004,1361,1743,0.7809999999999999,875,2645,3520,1890,561,462,1043,1731,7753,94.5
418,11.0,Phoenix Suns,82,19730,2958,6671,0.44299999999999995,415,1202,0.345,2543,5469,0.465,1392,1865,0.746,924,2406,3330,1586,734,383,1249,1862,7723,94.2
419,12.0,Orlando Magic,82,19830,2904,6768,0.429,429,1248,0.344,2475,5520,0.44799999999999995,1474,2000,0.737,1003,2350,3353,1584,547,308,1123,1744,7711,94.0
420,13.0,Golden State Warriors,82,19855,2875,6511,0.442,429,1283,0.33399999999999996,2446,5228,0.46799999999999997,1470,2028,0.725,1002,2533,3535,1681,576,389,1211,1691,7649,93.3
421,14.0,Cleveland Cavaliers,82,19855,2922,6753,0.433,247,786,0.314,2675,5967,0.44799999999999995,1528,2030,0.753,1118,2619,3737,1808,585,537,1216,1743,7619,92.9
422,15.0,Atlanta Hawks,82,19905,2829,6529,0.433,419,1249,0.335,2410,5280,0.456,1534,1976,0.7759999999999999,996,2507,3503,1648,627,408,1350,1826,7611,92.8
423,16.0,New York Knicks*,82,19880,2881,6513,0.442,406,1115,0.364,2475,5398,0.45899999999999996,1374,1732,0.7929999999999999,950,2543,3493,1695,608,391,1289,1897,7542,92.0
424,17.0,Washington Wizards,82,19830,2758,6556,0.42100000000000004,433,1269,0.341,2325,5287,0.44,1579,2211,0.7140000000000001,1115,2392,3507,1537,733,406,1439,1712,7528,91.8
425,18.0,New Orleans Hornets*,82,19830,2772,6605,0.42,531,1666,0.319,2241,4939,0.45399999999999996,1454,1937,0.7509999999999999,1091,2418,3509,1716,708,346,1228,1715,7529,91.8
426,19.0,San Antonio Spurs*,82,19755,2842,6434,0.442,408,1140,0.358,2434,5294,0.46,1409,2069,0.6809999999999999,1029,2669,3698,1676,661,537,1203,1667,7501,91.5
427,20.0,Indiana Pacers*,82,19805,2753,6322,0.435,449,1281,0.35100000000000003,2304,5041,0.457,1538,2014,0.764,965,2452,3417,1774,726,411,1182,1709,7493,91.4
428,21.0,Portland Trail Blazers,82,19980,2898,6467,0.44799999999999995,381,1102,0.34600000000000003,2517,5365,0.469,1263,1728,0.731,1040,2376,3416,1768,613,443,1213,1554,7440,90.7
429,22.0,New Jersey Nets*,82,19705,2813,6372,0.441,377,1123,0.336,2436,5249,0.46399999999999997,1398,1856,0.753,862,2473,3335,2009,709,322,1209,1722,7401,90.3
430,23.0,Miami Heat*,82,19755,2729,6417,0.425,485,1357,0.35700000000000004,2244,5060,0.44299999999999995,1459,1915,0.762,940,2459,3399,1565,590,313,1137,1812,7402,90.3
431,24.0,Detroit Pistons*,82,19780,2747,6314,0.435,333,968,0.344,2414,5346,0.452,1561,2074,0.753,1014,2492,3506,1702,659,570,1241,1664,7388,90.1
432,25.0,Houston Rockets*,82,19930,2738,6195,0.442,515,1406,0.366,2223,4789,0.46399999999999997,1371,1774,0.773,847,2647,3494,1579,560,443,1373,1762,7362,89.8
433,26.0,Chicago Bulls,82,19830,2798,6753,0.414,429,1256,0.342,2369,5497,0.431,1330,1834,0.725,1048,2519,3567,1793,659,396,1321,1911,7355,89.7
434,27.0,Utah Jazz,82,19780,2690,6172,0.436,252,786,0.321,2438,5386,0.45299999999999996,1639,2196,0.746,1103,2272,3375,1671,583,494,1365,2096,7271,88.7
435,28.0,Philadelphia 76ers,82,19855,2682,6260,0.428,339,992,0.342,2343,5268,0.445,1512,2009,0.753,941,2408,3349,1640,654,358,1307,1701,7215,88.0
436,29.0,Toronto Raptors,82,19980,2654,6348,0.418,461,1294,0.35600000000000004,2193,5054,0.434,1237,1650,0.75,830,2419,3249,1574,604,402,1164,1748,7006,85.4
437,,League Average,82,19820,2871,6545,0.439,425,1224,0.34700000000000003,2446,5321,0.46,1492,1985,0.752,991,2469,3461,1747,650,415,1228,1759,7659,93.4
438,1.0,Phoenix Suns*,82,19780,3351,7018,0.47700000000000004,796,2026,0.39299999999999996,2555,4992,0.512,1556,2080,0.748,967,2652,3619,1927,572,453,1125,1563,9054,110.4
439,2.0,Sacramento Kings*,82,19855,3203,6978,0.45899999999999996,522,1396,0.374,2681,5582,0.48,1577,2004,0.787,1023,2455,3478,2005,674,316,1073,1685,8505,103.7
440,3.0,Dallas Mavericks*,82,19730,3058,6691,0.457,463,1273,0.364,2595,5418,0.479,1826,2314,0.789,990,2530,3520,1610,708,461,1102,1827,8405,102.5
441,4.0,Miami Heat*,82,19980,3097,6368,0.486,475,1260,0.377,2622,5108,0.513,1658,2466,0.672,887,2639,3526,1790,528,474,1127,1814,8327,101.5
442,5.0,Boston Celtics*,82,19880,3046,6511,0.46799999999999997,437,1252,0.349,2609,5259,0.496,1775,2323,0.764,909,2438,3347,1810,667,423,1297,2000,8304,101.3
443,6.0,Washington Wizards*,82,19780,2966,6794,0.43700000000000006,514,1498,0.34299999999999997,2452,5296,0.46299999999999997,1795,2476,0.725,1133,2374,3507,1563,716,347,1172,1807,8241,100.5
444,7.0,Toronto Raptors,82,19805,2952,6656,0.444,648,1681,0.385,2304,4975,0.46299999999999997,1626,2101,0.774,844,2444,3288,1670,621,317,1087,1876,8178,99.7
445,8.0,Denver Nuggets*,82,19755,3038,6615,0.45899999999999996,320,940,0.34,2718,5675,0.479,1765,2313,0.763,967,2473,3440,1958,750,489,1224,1878,8161,99.5
446,9.0,Orlando Magic,82,19705,3034,6679,0.45399999999999996,320,916,0.349,2714,5763,0.47100000000000003,1772,2335,0.759,1038,2544,3582,1583,633,441,1322,1937,8160,99.5
447,10.0,Philadelphia 76ers*,82,19855,2946,6736,0.43700000000000006,505,1453,0.348,2441,5283,0.462,1731,2194,0.789,909,2536,3445,1710,756,321,1274,1878,8128,99.1
448,11.0,Seattle SuperSonics*,82,19755,2882,6498,0.444,666,1824,0.365,2216,4674,0.474,1683,2131,0.79,1041,2311,3352,1487,553,338,1113,1944,8113,98.9
449,12.0,Golden State Warriors,82,19905,3029,7039,0.43,624,1774,0.35200000000000004,2405,5265,0.457,1412,1955,0.722,1069,2436,3505,1811,642,420,1112,1833,8094,98.7
450,13.0,Los Angeles Lakers,82,19780,2895,6629,0.43700000000000006,644,1813,0.355,2251,4816,0.467,1661,2137,0.777,1028,2511,3539,1672,508,344,1176,1794,8095,98.7
451,14.0,New York Knicks,82,19880,2978,6599,0.451,441,1240,0.35600000000000004,2537,5359,0.473,1580,2060,0.767,965,2393,3358,1665,629,260,1204,1942,7977,97.3
452,15.0,Milwaukee Bucks,82,19780,2964,6580,0.45,325,925,0.35100000000000003,2639,5655,0.467,1720,2229,0.772,985,2405,3390,1720,529,289,1132,1797,7973,97.2
453,16.0,Minnesota Timberwolves,82,19755,3045,6629,0.45899999999999996,395,1145,0.345,2650,5484,0.483,1449,1820,0.7959999999999999,947,2580,3527,1918,460,447,1079,1774,7934,96.8
454,17.0,Cleveland Cavaliers,82,19855,2990,6687,0.447,300,904,0.332,2690,5783,0.465,1634,2174,0.752,1117,2352,3469,1851,654,461,1141,1850,7914,96.5
455,18.0,San Antonio Spurs*,82,19805,2923,6450,0.45299999999999996,507,1395,0.363,2416,5055,0.478,1535,2120,0.7240000000000001,987,2489,3476,1771,613,543,1126,1717,7888,96.2
456,19.0,Los Angeles Clippers,82,20030,2924,6368,0.45899999999999996,231,669,0.345,2693,5699,0.473,1770,2274,0.778,980,2455,3435,1901,599,422,1290,1819,7849,95.7
457,20.0,Houston Rockets*,82,19855,2846,6419,0.44299999999999995,553,1521,0.364,2293,4898,0.46799999999999997,1551,1986,0.7809999999999999,874,2601,3475,1733,563,378,1135,1807,7796,95.1
458,21.0,Chicago Bulls*,82,19830,2849,6592,0.43200000000000005,511,1433,0.35700000000000004,2338,5159,0.45299999999999996,1536,2048,0.75,1001,2591,3592,1743,576,369,1371,2028,7745,94.5
459,22.0,Charlotte Bobcats,82,19880,2961,6859,0.43200000000000005,320,881,0.363,2641,5978,0.442,1487,2096,0.7090000000000001,1083,2335,3418,1794,695,440,1192,1894,7729,94.3
460,23.0,Memphis Grizzlies*,82,19705,2802,6271,0.447,531,1486,0.35700000000000004,2271,4785,0.475,1526,2024,0.754,887,2307,3194,1716,699,476,1197,1910,7661,93.4
461,24.0,Detroit Pistons*,82,19955,2851,6421,0.444,363,1053,0.345,2488,5368,0.46299999999999997,1588,2150,0.7390000000000001,1054,2507,3561,1787,576,497,1133,1638,7653,93.3
462,25.0,Indiana Pacers*,82,19905,2668,6169,0.43200000000000005,542,1575,0.344,2126,4594,0.46299999999999997,1748,2206,0.792,868,2418,3286,1489,615,357,1173,1890,7626,93.0
463,26.0,Utah Jazz,82,19780,2828,6301,0.449,250,762,0.32799999999999996,2578,5539,0.465,1719,2272,0.757,1047,2243,3290,1826,541,374,1292,2189,7625,93.0
464,27.0,Portland Trail Blazers,82,19730,2896,6422,0.451,420,1161,0.36200000000000004,2476,5261,0.47100000000000003,1409,1944,0.725,970,2404,3374,1722,583,544,1308,1703,7621,92.9
465,28.0,Atlanta Hawks,82,19855,2942,6672,0.441,304,973,0.312,2638,5699,0.46299999999999997,1417,1994,0.711,1100,2335,3435,1614,629,344,1319,2009,7605,92.7
466,29.0,New Jersey Nets*,82,19905,2753,6419,0.429,435,1203,0.36200000000000004,2318,5216,0.444,1555,2039,0.763,855,2387,3242,1772,650,308,1164,1985,7496,91.4
467,30.0,New Orleans Hornets,82,19930,2718,6556,0.415,415,1316,0.315,2303,5240,0.44,1401,1830,0.7659999999999999,1019,2281,3300,1724,550,310,1217,1883,7252,88.4
468,,League Average,82,19833,2948,6588,0.447,459,1292,0.35600000000000004,2489,5296,0.47,1615,2137,0.7559999999999999,985,2448,3432,1745,616,399,1189,1856,7970,97.2
469,1.0,Phoenix Suns*,82,19955,3430,7167,0.479,837,2097,0.39899999999999997,2593,5070,0.511,1189,1475,0.8059999999999999,778,2650,3428,2179,549,412,1088,1683,8886,108.4
470,2.0,Seattle SuperSonics,82,19830,3077,6711,0.45899999999999996,605,1631,0.371,2472,5080,0.48700000000000004,1652,2104,0.785,1013,2233,3246,1696,622,306,1208,1933,8411,102.6
471,3.0,Washington Wizards*,82,19830,2975,6656,0.447,497,1394,0.35700000000000004,2478,5262,0.47100000000000003,1889,2496,0.757,1035,2344,3379,1523,658,339,1143,1855,8336,101.7
472,4.0,Toronto Raptors,82,19955,3013,6639,0.45399999999999996,608,1620,0.375,2405,5019,0.479,1653,2089,0.7909999999999999,864,2291,3155,1593,529,272,1071,1965,8287,101.1
473,5.0,Denver Nuggets*,82,19930,3078,6672,0.461,350,1076,0.325,2728,5596,0.48700000000000004,1721,2312,0.7440000000000001,903,2486,3389,1921,698,463,1216,1863,8227,100.3
474,6.0,Miami Heat*,82,19755,3039,6355,0.478,497,1441,0.345,2542,4914,0.517,1616,2310,0.7,858,2675,3533,1692,522,442,1186,1871,8191,99.9
475,7.0,Philadelphia 76ers,82,19905,3001,6546,0.45799999999999996,375,1031,0.364,2626,5515,0.47600000000000003,1770,2330,0.76,873,2425,3298,1653,651,404,1159,1712,8147,99.4
476,8.0,Los Angeles Lakers*,82,19855,2992,6607,0.45299999999999996,552,1583,0.349,2440,5024,0.486,1618,2172,0.745,970,2488,3458,1734,628,350,1143,1894,8154,99.4
477,9.0,Dallas Mavericks*,82,19880,2948,6375,0.462,416,1113,0.374,2532,5262,0.48100000000000004,1818,2322,0.7829999999999999,1030,2431,3461,1473,593,488,1112,1834,8130,99.1
478,10.0,Sacramento Kings*,82,19830,2954,6500,0.45399999999999996,494,1408,0.35100000000000003,2460,5092,0.483,1704,2173,0.784,852,2473,3325,1825,608,299,1199,1672,8106,98.9
479,11.0,Golden State Warriors,82,19830,2939,6785,0.433,625,1832,0.341,2314,4953,0.467,1573,2190,0.718,980,2485,3465,1694,604,357,1156,1941,8076,98.5
480,12.0,Boston Celtics,82,19880,2951,6322,0.467,467,1290,0.36200000000000004,2484,5032,0.494,1664,2204,0.755,813,2432,3245,1716,578,422,1359,2033,8033,98.0
481,13.0,Milwaukee Bucks*,82,19855,2976,6566,0.45299999999999996,507,1335,0.38,2469,5231,0.47200000000000003,1561,2115,0.738,929,2448,3377,1769,597,270,1197,1902,8020,97.8
482,14.0,Chicago Bulls*,82,19905,3004,6737,0.446,560,1477,0.379,2444,5260,0.465,1452,1967,0.738,906,2602,3508,1804,508,345,1224,2038,8020,97.8
483,15.0,Cleveland Cavaliers*,82,19830,2908,6412,0.45399999999999996,497,1465,0.33899999999999997,2411,4947,0.48700000000000004,1689,2318,0.7290000000000001,959,2511,3470,1560,567,392,1137,1733,8002,97.6
484,16.0,Atlanta Hawks,82,19880,2946,6496,0.45399999999999996,424,1154,0.36700000000000005,2522,5342,0.47200000000000003,1656,2207,0.75,1069,2232,3301,1625,587,394,1284,2054,7972,97.2
485,17.0,Los Angeles Clippers*,82,19805,2993,6443,0.465,290,843,0.344,2703,5600,0.483,1694,2142,0.7909999999999999,828,2704,3532,1708,534,503,1185,1872,7970,97.2
486,18.0,Charlotte Bobcats,82,19905,2961,6843,0.433,428,1261,0.33899999999999997,2533,5582,0.45399999999999996,1593,2186,0.7290000000000001,990,2270,3260,1717,822,354,1167,1960,7943,96.9
487,19.0,Detroit Pistons*,82,19830,2983,6558,0.455,557,1451,0.384,2426,5107,0.475,1418,1950,0.727,975,2347,3322,1971,580,490,931,1513,7941,96.8
488,20.0,New York Knicks,82,19930,2822,6206,0.455,320,884,0.36200000000000004,2502,5322,0.47,1878,2587,0.726,1034,2360,3394,1468,555,271,1449,2157,7842,95.6
489,21.0,San Antonio Spurs*,82,19805,2993,6342,0.47200000000000003,524,1362,0.385,2469,4980,0.496,1327,1891,0.7020000000000001,851,2548,3399,1717,543,467,1126,1714,7837,95.6
490,22.0,Orlando Magic,82,19905,2911,6167,0.47200000000000003,299,796,0.376,2612,5371,0.486,1663,2277,0.73,892,2402,3294,1495,532,362,1240,1908,7784,94.9
491,23.0,Indiana Pacers*,82,19730,2786,6274,0.444,536,1536,0.349,2250,4738,0.475,1591,2158,0.737,898,2559,3457,1631,598,409,1254,1821,7699,93.9
492,24.0,New Jersey Nets*,82,19780,2778,6317,0.44,477,1447,0.33,2301,4870,0.47200000000000003,1658,2187,0.758,822,2539,3361,1884,558,278,1119,1903,7691,93.8
493,25.0,New Orleans/Oklahoma City Hornets,82,19805,2831,6428,0.44,300,885,0.33899999999999997,2531,5543,0.457,1649,2176,0.758,918,2379,3297,1519,611,311,1095,1786,7611,92.8
494,26.0,Utah Jazz,82,19880,2744,6207,0.442,311,925,0.336,2433,5282,0.461,1774,2466,0.7190000000000001,1071,2380,3451,1772,524,492,1290,2032,7573,92.4
495,27.0,Memphis Grizzlies*,82,19855,2746,6125,0.44799999999999995,590,1578,0.374,2156,4547,0.474,1476,2077,0.711,834,2379,3213,1586,600,442,1134,1757,7558,92.2
496,28.0,Minnesota Timberwolves,82,19855,2888,6340,0.456,310,942,0.32899999999999996,2578,5398,0.478,1436,1895,0.758,811,2422,3233,1716,559,471,1189,1889,7522,91.7
497,29.0,Houston Rockets,82,19830,2708,6252,0.433,469,1414,0.332,2239,4838,0.46299999999999997,1502,1980,0.759,849,2565,3414,1580,588,320,1193,1863,7387,90.1
498,30.0,Portland Trail Blazers,82,19730,2791,6267,0.445,364,1042,0.349,2427,5225,0.46399999999999997,1339,1944,0.6890000000000001,886,2203,3089,1490,529,435,1205,1828,7285,88.8
499,,League Average,82,19852,2939,6477,0.45399999999999996,470,1310,0.358,2469,5167,0.478,1607,2157,0.745,916,2442,3358,1690,588,385,1182,1866,7955,97.0
500,1.0,Phoenix Suns*,82,19905,3388,6855,0.494,785,1965,0.39899999999999997,2603,4890,0.532,1476,1827,0.8079999999999999,737,2583,3320,2122,553,394,1189,1659,9037,110.2
501,2.0,Golden State Warriors*,82,19755,3261,7048,0.46299999999999997,700,1967,0.35600000000000004,2561,5081,0.504,1515,2113,0.7170000000000001,940,2456,3396,1950,750,466,1309,1933,8737,106.5
502,3.0,Denver Nuggets*,82,19780,3164,6805,0.465,484,1440,0.336,2680,5365,0.5,1827,2449,0.746,1001,2558,3559,1920,678,435,1352,1756,8639,105.4
503,4.0,Washington Wizards*,82,19830,3070,6820,0.45,561,1614,0.348,2509,5206,0.48200000000000004,1855,2425,0.765,998,2379,3377,1660,635,375,1133,1823,8556,104.3
504,5.0,Los Angeles Lakers*,82,20030,3103,6664,0.466,608,1724,0.353,2495,4940,0.505,1660,2221,0.747,886,2495,3381,1850,600,421,1273,1889,8474,103.3
505,6.0,Memphis Grizzlies,82,19980,2998,6448,0.465,500,1362,0.36700000000000005,2498,5086,0.491,1835,2410,0.7609999999999999,866,2375,3241,1680,564,407,1343,1827,8331,101.6
506,7.0,Utah Jazz*,82,19805,3069,6471,0.474,354,1056,0.335,2715,5415,0.501,1830,2462,0.743,1030,2456,3486,2024,577,339,1277,2067,8322,101.5
507,8.0,Sacramento Kings,82,19805,2941,6532,0.45,530,1513,0.35,2411,5019,0.48,1891,2473,0.765,797,2396,3193,1665,671,265,1194,1792,8303,101.3
508,9.0,Dallas Mavericks*,82,19755,3010,6442,0.467,535,1404,0.381,2475,5038,0.491,1646,2045,0.805,920,2515,3435,1632,560,408,1140,1837,8201,100.0
509,10.0,Milwaukee Bucks,82,19855,3121,6714,0.465,524,1472,0.35600000000000004,2597,5242,0.495,1406,1919,0.733,941,2272,3213,1771,587,224,1240,1821,8172,99.7
510,11.0,Toronto Raptors*,82,19755,3032,6547,0.46299999999999997,531,1464,0.363,2501,5083,0.49200000000000005,1562,1982,0.7879999999999999,755,2480,3235,1822,581,321,1104,1672,8157,99.5
511,12.0,Seattle SuperSonics,82,19830,3047,6628,0.46,525,1451,0.36200000000000004,2522,5177,0.48700000000000004,1511,1911,0.7909999999999999,928,2322,3250,1695,631,301,1268,1801,8130,99.1
512,13.0,Chicago Bulls*,82,19780,3046,6663,0.457,480,1237,0.38799999999999996,2566,5426,0.473,1528,2083,0.7340000000000001,984,2597,3581,1832,639,445,1310,1908,8100,98.8
513,14.0,San Antonio Spurs*,82,19780,2999,6328,0.474,595,1561,0.381,2404,4767,0.504,1486,1980,0.7509999999999999,761,2577,3338,1814,587,417,1137,1588,8079,98.5
514,15.0,New Jersey Nets*,82,19880,2913,6379,0.457,609,1676,0.363,2304,4703,0.49,1566,2153,0.727,822,2525,3347,1962,499,273,1212,1869,8001,97.6
515,16.0,New York Knicks,82,20005,2903,6356,0.457,474,1370,0.34600000000000003,2429,4986,0.48700000000000004,1714,2396,0.715,1032,2516,3548,1532,543,260,1405,1932,7994,97.5
516,17.0,Houston Rockets*,82,19855,2906,6528,0.445,705,1893,0.37200000000000005,2201,4635,0.475,1436,1906,0.753,880,2673,3553,1704,583,337,1162,1710,7953,97.0
517,18.0,Charlotte Bobcats,82,20005,2960,6643,0.446,457,1280,0.35700000000000004,2503,5363,0.467,1568,2136,0.7340000000000001,920,2346,3266,1836,638,369,1224,1985,7945,96.9
518,19.0,Cleveland Cavaliers*,82,19880,2978,6658,0.447,494,1404,0.35200000000000004,2484,5254,0.473,1484,2133,0.696,1039,2529,3568,1708,625,353,1177,1781,7934,96.8
519,20.0,Minnesota Timberwolves,82,20005,2997,6503,0.461,384,1089,0.353,2613,5414,0.483,1499,1892,0.792,819,2474,3293,1848,532,325,1278,1758,7877,96.1
520,21.0,Detroit Pistons*,82,19880,2942,6484,0.45399999999999996,449,1305,0.344,2493,5179,0.48100000000000004,1539,1988,0.774,948,2374,3322,1768,583,472,1001,1672,7872,96.0
521,22.0,Boston Celtics,82,19855,2858,6454,0.44299999999999995,471,1283,0.36700000000000005,2387,5171,0.462,1670,2178,0.767,918,2391,3309,1630,589,382,1350,1971,7857,95.8
522,23.0,Indiana Pacers,82,19780,2872,6561,0.43799999999999994,481,1389,0.34600000000000003,2391,5172,0.462,1615,2125,0.76,990,2441,3431,1680,599,447,1335,1912,7840,95.6
523,24.0,Los Angeles Clippers,82,19730,2880,6318,0.456,314,903,0.348,2566,5415,0.474,1769,2245,0.7879999999999999,888,2484,3372,1762,596,472,1239,1858,7843,95.6
524,25.0,New Orleans/Oklahoma City Hornets,82,19880,2971,6674,0.445,455,1256,0.36200000000000004,2516,5418,0.46399999999999997,1436,1941,0.74,1025,2512,3537,1537,522,347,1187,1620,7833,95.5
525,26.0,Philadelphia 76ers,82,19880,2932,6408,0.45799999999999996,284,823,0.345,2648,5585,0.474,1637,2135,0.767,899,2353,3252,1669,590,390,1258,1671,7785,94.9
526,27.0,Orlando Magic*,82,19780,2875,6090,0.47200000000000003,342,962,0.35600000000000004,2533,5128,0.494,1679,2393,0.7020000000000001,920,2418,3338,1525,565,416,1392,1904,7771,94.8
527,28.0,Miami Heat*,82,19855,2919,6288,0.46399999999999997,528,1539,0.34299999999999997,2391,4749,0.503,1393,2019,0.69,817,2526,3343,1681,566,442,1201,1749,7759,94.6
528,29.0,Portland Trail Blazers,82,19955,2874,6392,0.45,426,1232,0.34600000000000003,2448,5160,0.474,1543,2006,0.769,923,2299,3222,1513,555,380,1236,1931,7717,94.1
529,30.0,Atlanta Hawks,82,19880,2831,6372,0.444,341,1038,0.32899999999999996,2490,5334,0.467,1677,2203,0.7609999999999999,976,2312,3288,1573,609,446,1306,1970,7680,93.7
530,,League Average,82,19858,2995,6536,0.45799999999999996,498,1389,0.358,2498,5147,0.485,1608,2138,0.752,912,2454,3366,1746,594,378,1241,1822,8097,98.7
531,1.0,Golden State Warriors,82,19780,3403,7406,0.45899999999999996,761,2185,0.348,2642,5221,0.506,1538,2044,0.752,1045,2496,3541,1833,744,377,1082,1875,9105,111.0
532,2.0,Denver Nuggets*,82,19855,3307,7038,0.47,569,1605,0.355,2738,5433,0.504,1891,2519,0.7509999999999999,918,2698,3616,2024,752,551,1203,1731,9074,110.7
533,3.0,Phoenix Suns*,82,19780,3392,6782,0.5,694,1764,0.39299999999999996,2698,5018,0.5379999999999999,1548,1977,0.7829999999999999,720,2683,3403,2188,532,518,1184,1633,9026,110.1
534,4.0,Los Angeles Lakers*,82,19780,3248,6818,0.47600000000000003,662,1751,0.37799999999999995,2586,5067,0.51,1746,2270,0.769,898,2722,3620,2003,654,438,1156,1691,8904,108.6
535,5.0,Utah Jazz*,82,19705,3279,6592,0.49700000000000005,407,1095,0.37200000000000005,2872,5497,0.522,1745,2298,0.759,942,2410,3352,2165,717,355,1200,1970,8710,106.2
536,6.0,Orlando Magic*,82,19780,3058,6446,0.474,801,2074,0.386,2257,4372,0.516,1650,2288,0.721,768,2677,3445,1706,520,333,1173,1688,8567,104.5
537,7.0,Indiana Pacers,82,19755,3102,6993,0.444,755,2021,0.374,2347,4972,0.47200000000000003,1568,2042,0.768,904,2633,3537,1864,623,412,1236,1921,8527,104.0
538,8.0,Sacramento Kings,82,19830,3043,6558,0.46399999999999997,510,1367,0.373,2533,5191,0.488,1812,2272,0.7979999999999999,829,2456,3285,1567,651,334,1317,1839,8408,102.5
539,9.0,New Orleans Hornets*,82,19805,3164,6796,0.466,630,1621,0.389,2534,5175,0.49,1312,1707,0.769,937,2494,3431,1785,637,321,974,1531,8270,100.9
540,10.0,Memphis Grizzlies,82,19805,3060,6737,0.45399999999999996,620,1779,0.349,2440,4958,0.49200000000000005,1517,2097,0.723,848,2567,3415,1574,503,386,1251,1592,8257,100.7
541,11.0,Boston Celtics*,82,19755,2986,6286,0.475,596,1564,0.381,2390,4722,0.506,1677,2176,0.7709999999999999,830,2615,3445,1833,696,379,1246,1864,8245,100.5
542,12.0,Dallas Mavericks*,82,19730,3025,6515,0.46399999999999997,494,1403,0.35200000000000004,2531,5112,0.495,1690,2075,0.8140000000000001,883,2643,3526,1720,490,402,1037,1786,8234,100.4
543,13.0,Toronto Raptors*,82,19830,3148,6726,0.46799999999999997,572,1459,0.392,2576,5267,0.489,1347,1658,0.812,790,2496,3286,1953,570,336,959,1596,8215,100.2
544,14.0,Washington Wizards*,82,19905,2986,6695,0.446,575,1614,0.35600000000000004,2411,5081,0.475,1557,1991,0.782,1007,2404,3411,1607,632,391,1082,1606,8104,98.8
545,15.0,Atlanta Hawks*,82,19855,2975,6552,0.45399999999999996,384,1078,0.35600000000000004,2591,5474,0.473,1720,2227,0.772,1008,2454,3462,1804,600,448,1223,1673,8054,98.2
546,16.0,Detroit Pistons*,82,19730,2999,6551,0.45799999999999996,487,1330,0.366,2512,5221,0.48100000000000004,1507,1965,0.767,974,2423,3397,1831,583,472,956,1688,7992,97.5
547,17.0,Seattle SuperSonics,82,19830,3125,7032,0.444,313,939,0.33299999999999996,2812,6093,0.462,1436,1866,0.77,971,2688,3659,1748,531,400,1310,1680,7999,97.5
548,18.0,Chicago Bulls,82,19805,2987,6861,0.435,474,1305,0.363,2513,5556,0.452,1533,2029,0.7559999999999999,1050,2478,3528,1811,635,429,1197,1784,7981,97.3
549,19.0,Charlotte Bobcats,82,19880,2960,6554,0.452,529,1443,0.36700000000000005,2431,5111,0.47600000000000003,1510,2115,0.7140000000000001,892,2440,3332,1748,614,402,1204,1777,7959,97.1
550,20.0,Milwaukee Bucks,82,19855,3026,6745,0.449,452,1313,0.344,2574,5432,0.474,1452,1980,0.733,1055,2363,3418,1760,544,361,1210,1748,7956,97.0
551,21.0,New York Knicks,82,19880,2967,6757,0.439,490,1454,0.337,2477,5303,0.467,1524,2095,0.727,1029,2457,3486,1530,521,213,1187,1761,7948,96.9
552,22.0,Houston Rockets*,82,19730,3003,6698,0.44799999999999995,583,1707,0.342,2420,4991,0.485,1342,1848,0.726,1002,2659,3661,1757,598,420,1125,1609,7931,96.7
553,23.0,Philadelphia 76ers*,82,19755,3056,6648,0.46,302,952,0.317,2754,5696,0.483,1509,2137,0.706,1067,2370,3437,1673,712,400,1172,1620,7923,96.6
554,24.0,Cleveland Cavaliers*,82,19855,2937,6697,0.439,552,1544,0.358,2385,5153,0.46299999999999997,1477,2061,0.7170000000000001,1092,2563,3655,1640,579,427,1145,1712,7903,96.4
555,25.0,New Jersey Nets,82,19830,2856,6450,0.44299999999999995,498,1430,0.348,2358,5020,0.47,1647,2237,0.736,913,2520,3433,1925,521,390,1229,1855,7857,95.8
556,26.0,Minnesota Timberwolves,82,19730,3076,6817,0.451,441,1259,0.35,2635,5558,0.474,1246,1693,0.736,964,2428,3392,1630,616,306,1188,1885,7839,95.6
557,27.0,San Antonio Spurs*,82,19730,2938,6424,0.457,594,1610,0.369,2344,4814,0.48700000000000004,1350,1774,0.7609999999999999,771,2612,3383,1718,521,337,1035,1537,7820,95.4
558,28.0,Portland Trail Blazers,82,19905,2935,6546,0.44799999999999995,538,1426,0.377,2397,5120,0.46799999999999997,1412,1841,0.767,901,2438,3339,1733,455,360,1056,1642,7820,95.4
559,29.0,Los Angeles Clippers,82,19805,2820,6445,0.43799999999999994,350,1079,0.324,2470,5366,0.46,1702,2178,0.7809999999999999,800,2491,3291,1732,557,398,1180,1745,7692,93.8
560,30.0,Miami Heat,82,19830,2808,6336,0.44299999999999995,491,1373,0.358,2317,4963,0.467,1384,1903,0.727,743,2342,3085,1644,589,355,1202,1670,7491,91.4
561,,League Average,82,19803,3056,6683,0.457,537,1485,0.36200000000000004,2518,5199,0.484,1545,2045,0.755,918,2524,3442,1784,597,388,1157,1724,8194,99.9
562,1.0,Phoenix Suns,82,19755,3373,6695,0.504,553,1445,0.38299999999999995,2820,5250,0.537,1675,2251,0.7440000000000001,900,2520,3420,1905,589,420,1288,1691,8974,109.4
563,2.0,Golden State Warriors,82,19880,3231,7055,0.45799999999999996,550,1475,0.373,2681,5580,0.48,1893,2392,0.7909999999999999,953,2492,3445,1711,638,527,1201,1842,8905,108.6
564,3.0,Los Angeles Lakers*,82,19780,3307,6981,0.474,547,1516,0.361,2760,5465,0.505,1607,2087,0.77,1015,2587,3602,1908,718,420,1103,1698,8768,106.9
565,4.0,New York Knicks,82,19805,3157,7091,0.445,823,2284,0.36,2334,4807,0.486,1490,1900,0.784,911,2545,3456,1738,610,204,1174,1672,8627,105.2
566,5.0,Indiana Pacers,82,19830,3220,7080,0.455,652,1725,0.37799999999999995,2568,5355,0.48,1525,1890,0.807,924,2661,3585,1775,573,434,1189,1895,8617,105.1
567,6.0,Denver Nuggets*,82,19730,3058,6510,0.47,548,1477,0.371,2510,5033,0.499,1891,2487,0.76,905,2507,3412,1820,710,492,1257,1874,8555,104.3
568,7.0,Utah Jazz*,82,19880,3143,6623,0.475,392,1122,0.349,2751,5501,0.5,1814,2352,0.7709999999999999,940,2423,3363,2024,719,374,1210,1830,8492,103.6
569,8.0,Chicago Bulls*,82,19930,3126,6846,0.457,493,1293,0.381,2633,5553,0.474,1633,2052,0.7959999999999999,970,2481,3451,1732,615,453,1192,1709,8378,102.2
570,9.0,Dallas Mavericks*,82,19805,3128,6770,0.462,571,1632,0.35,2557,5138,0.498,1516,1852,0.8190000000000001,909,2595,3504,1779,591,429,1043,1600,8343,101.7
571,10.0,Orlando Magic*,82,19730,2929,6416,0.457,817,2147,0.381,2112,4269,0.495,1611,2253,0.715,819,2728,3547,1593,570,439,1142,1664,8286,101.0
572,11.0,Boston Celtics*,82,19880,3075,6333,0.486,538,1355,0.397,2537,4978,0.51,1587,2075,0.765,869,2586,3455,1862,621,387,1280,1897,8275,100.9
573,12.0,Sacramento Kings,82,19905,2990,6685,0.447,586,1594,0.368,2404,5091,0.47200000000000003,1682,2107,0.7979999999999999,840,2366,3206,1619,569,349,1266,1910,8248,100.6
574,13.0,Cleveland Cavaliers*,82,19780,3022,6454,0.46799999999999997,656,1670,0.39299999999999996,2366,4784,0.495,1523,2012,0.757,886,2574,3460,1663,593,435,1045,1663,8223,100.3
575,14.0,Portland Trail Blazers*,82,19830,3018,6494,0.465,596,1555,0.38299999999999995,2422,4939,0.49,1521,1988,0.765,1060,2360,3420,1667,550,402,1055,1671,8153,99.4
576,15.0,Milwaukee Bucks,82,19780,3009,6755,0.445,511,1408,0.363,2498,5347,0.467,1613,2067,0.78,973,2367,3340,1802,609,308,1154,1986,8142,99.3
577,16.0,Toronto Raptors,82,19805,3054,6673,0.45799999999999996,479,1289,0.37200000000000005,2575,5384,0.478,1534,1861,0.8240000000000001,802,2513,3315,1835,523,390,1098,1593,8121,99.0
578,17.0,Houston Rockets*,82,19805,2959,6526,0.45299999999999996,621,1656,0.375,2338,4870,0.48,1531,1903,0.805,862,2662,3524,1662,548,355,1158,1553,8070,98.4
579,18.0,Miami Heat*,82,19955,3034,6646,0.457,582,1631,0.35700000000000004,2452,5015,0.489,1411,1871,0.754,828,2411,3239,1671,651,451,1026,1696,8061,98.3
580,19.0,New Jersey Nets,82,19830,2925,6536,0.44799999999999995,652,1735,0.376,2273,4801,0.473,1542,1980,0.779,850,2415,3265,1636,559,391,1075,1838,8044,98.1
581,20.0,Atlanta Hawks*,82,19705,2956,6451,0.45799999999999996,597,1633,0.366,2359,4818,0.49,1537,2085,0.737,870,2412,3282,1657,603,376,1048,1610,8046,98.1
582,21.0,Minnesota Timberwolves,82,19805,2986,6766,0.441,543,1539,0.353,2443,5227,0.467,1504,1957,0.769,975,2442,3417,1674,512,322,1165,1785,8019,97.8
583,22.0,Philadelphia 76ers*,82,19755,2997,6532,0.45899999999999996,341,1072,0.318,2656,5460,0.486,1652,2216,0.745,1039,2336,3375,1647,658,415,1157,1650,7987,97.4
584,23.0,Oklahoma City Thunder,82,19805,2999,6716,0.447,328,949,0.34600000000000003,2671,5767,0.46299999999999997,1626,2069,0.7859999999999999,999,2497,3496,1663,608,371,1330,1655,7952,97.0
585,24.0,San Antonio Spurs*,82,19905,3042,6534,0.466,625,1620,0.386,2417,4914,0.49200000000000005,1249,1641,0.7609999999999999,728,2638,3366,1736,474,329,963,1546,7958,97.0
586,25.0,Washington Wizards,82,19705,2994,6655,0.45,395,1198,0.33,2599,5457,0.47600000000000003,1494,1948,0.767,956,2330,3286,1641,619,365,1146,1679,7877,96.1
587,26.0,New Orleans Hornets*,82,19755,2911,6366,0.457,556,1526,0.364,2355,4840,0.48700000000000004,1479,1833,0.807,802,2453,3255,1609,593,338,1029,1665,7857,95.8
588,27.0,Los Angeles Clippers,82,19880,2955,6696,0.441,535,1513,0.354,2420,5183,0.467,1354,1839,0.736,890,2377,3267,1723,572,482,1221,1650,7799,95.1
589,28.0,Detroit Pistons*,82,19905,2981,6559,0.45399999999999996,377,1079,0.349,2604,5480,0.475,1388,1849,0.7509999999999999,949,2448,3397,1689,493,377,973,1712,7727,94.2
590,29.0,Memphis Grizzlies,82,19805,2865,6311,0.45399999999999996,398,1106,0.36,2467,5205,0.474,1570,2077,0.7559999999999999,847,2337,3184,1423,615,385,1252,1777,7698,93.9
591,30.0,Charlotte Bobcats,82,19930,2866,6299,0.455,490,1339,0.366,2376,4960,0.479,1455,1965,0.74,886,2366,3252,1741,580,397,1279,1754,7677,93.6
592,,League Average,82,19822,3044,6635,0.45899999999999996,545,1486,0.36700000000000005,2499,5149,0.485,1564,2029,0.7709999999999999,905,2481,3386,1720,596,394,1151,1726,8196,100.0
593,1.0,Phoenix Suns*,82,19730,3339,6788,0.49200000000000005,730,1770,0.41200000000000003,2609,5018,0.52,1631,2117,0.77,910,2616,3526,1912,479,418,1210,1713,9039,110.2
594,2.0,Golden State Warriors,82,19730,3329,7094,0.469,633,1687,0.375,2696,5407,0.499,1631,2085,0.782,753,2397,3150,1839,761,340,1204,1886,8922,108.8
595,3.0,Denver Nuggets*,82,19780,3124,6678,0.46799999999999997,544,1517,0.359,2580,5161,0.5,1937,2508,0.772,889,2505,3394,1719,683,417,1136,1844,8729,106.5
596,4.0,Utah Jazz*,82,19755,3227,6575,0.491,439,1207,0.364,2788,5368,0.519,1654,2233,0.741,872,2588,3460,2187,675,400,1246,1859,8547,104.2
597,5.0,Toronto Raptors,82,19780,3199,6631,0.48200000000000004,518,1397,0.371,2681,5234,0.512,1618,2118,0.764,806,2507,3313,1804,469,384,1100,1819,8534,104.1
598,6.0,Orlando Magic*,82,19730,3005,6394,0.47,841,2241,0.375,2164,4153,0.521,1575,2176,0.7240000000000001,810,2736,3546,1615,512,456,1155,1629,8426,102.8
599,7.0,Memphis Grizzlies,82,19905,3223,6875,0.469,344,1020,0.337,2879,5855,0.49200000000000005,1614,2202,0.733,1070,2496,3566,1543,645,399,1248,1655,8404,102.5
600,8.0,Houston Rockets,82,19905,3094,6923,0.447,646,1838,0.35100000000000003,2448,5085,0.48100000000000004,1561,2022,0.772,971,2471,3442,1790,583,318,1188,1712,8395,102.4
601,9.0,Cleveland Cavaliers*,82,19780,3101,6391,0.485,602,1582,0.381,2499,4809,0.52,1569,2180,0.72,791,2692,3483,1835,564,425,1137,1591,8373,102.1
602,10.0,New York Knicks,82,19880,3127,6876,0.455,743,2145,0.34600000000000003,2384,4731,0.504,1376,1759,0.782,836,2477,3313,1772,586,305,1148,1638,8373,102.1
603,11.0,Dallas Mavericks*,82,19880,3140,6760,0.46399999999999997,558,1498,0.37200000000000005,2582,5262,0.491,1526,1870,0.816,834,2586,3420,1917,624,449,1059,1563,8364,102.0
604,12.0,Los Angeles Lakers*,82,19830,3144,6875,0.457,532,1562,0.341,2612,5313,0.49200000000000005,1519,1985,0.765,973,2662,3635,1730,612,400,1096,1592,8339,101.7
605,13.0,Atlanta Hawks*,82,19855,3181,6801,0.46799999999999997,524,1455,0.36,2657,5346,0.49700000000000005,1452,1914,0.759,969,2451,3420,1789,592,413,980,1632,8338,101.7
606,14.0,Oklahoma City Thunder*,82,19805,3063,6629,0.462,418,1229,0.34,2645,5400,0.49,1778,2210,0.805,960,2607,3567,1639,654,481,1227,1743,8322,101.5
607,15.0,San Antonio Spurs*,82,19780,3150,6659,0.473,554,1547,0.358,2596,5112,0.508,1458,1969,0.74,887,2621,3508,1829,516,381,1116,1669,8312,101.4
608,16.0,Indiana Pacers,82,19705,3020,6823,0.44299999999999995,659,1896,0.348,2361,4927,0.479,1564,2019,0.775,785,2618,3403,1730,585,439,1232,1848,8263,100.8
609,17.0,New Orleans Hornets,82,19830,3178,6842,0.46399999999999997,571,1572,0.363,2607,5270,0.495,1293,1661,0.778,852,2450,3302,1828,625,300,1103,1606,8220,100.2
610,18.0,Sacramento Kings,82,19880,3144,6895,0.456,482,1383,0.349,2662,5512,0.483,1430,1969,0.726,977,2518,3495,1679,564,366,1226,1827,8200,100.0
611,19.0,Boston Celtics*,82,19780,3039,6294,0.483,499,1433,0.348,2540,4861,0.523,1559,2090,0.746,716,2449,3165,1930,701,402,1219,1816,8136,99.2
612,20.0,Minnesota Timberwolves,82,19780,3106,6923,0.449,403,1181,0.341,2703,5742,0.47100000000000003,1436,1926,0.746,962,2556,3518,1626,597,306,1333,1699,8051,98.2
613,21.0,Portland Trail Blazers*,82,19855,2974,6453,0.461,491,1388,0.354,2483,5065,0.49,1606,2033,0.79,913,2383,3296,1674,523,350,1012,1715,8045,98.1
614,22.0,Philadelphia 76ers,82,19805,3087,6706,0.46,474,1381,0.34299999999999997,2613,5325,0.491,1366,1808,0.7559999999999999,941,2421,3362,1723,667,439,1192,1677,8014,97.7
615,23.0,Milwaukee Bucks*,82,19980,3050,6998,0.436,645,1813,0.35600000000000004,2405,5185,0.46399999999999997,1264,1675,0.755,965,2560,3525,1740,580,385,1085,1823,8009,97.7
616,24.0,Chicago Bulls*,82,19905,3081,6825,0.451,352,1066,0.33,2729,5759,0.474,1479,1962,0.754,937,2715,3652,1704,531,478,1175,1648,7993,97.5
617,25.0,Miami Heat*,82,19880,2984,6518,0.45799999999999996,494,1426,0.34600000000000003,2490,5092,0.489,1452,1931,0.752,875,2553,3428,1548,605,457,1079,1710,7914,96.5
618,26.0,Washington Wizards,82,19830,3008,6700,0.449,432,1225,0.353,2576,5475,0.47100000000000003,1444,1895,0.762,966,2458,3424,1557,493,421,1219,1752,7892,96.2
619,27.0,Los Angeles Clippers,82,19705,3002,6601,0.455,483,1457,0.332,2519,5144,0.49,1362,1867,0.73,927,2502,3429,1810,532,466,1285,1581,7849,95.7
620,28.0,Charlotte Bobcats*,82,19880,2858,6306,0.45299999999999996,460,1331,0.34600000000000003,2398,4975,0.48200000000000004,1637,2180,0.7509999999999999,858,2490,3348,1658,632,446,1290,1597,7813,95.3
621,29.0,Detroit Pistons,82,19780,2940,6602,0.445,374,1190,0.314,2566,5412,0.474,1455,1998,0.728,1053,2242,3295,1591,596,313,1100,1822,7709,94.0
622,30.0,New Jersey Nets,82,19780,2813,6554,0.429,377,1185,0.318,2436,5369,0.45399999999999996,1572,2015,0.78,897,2358,3255,1540,573,393,1182,1643,7575,92.4
623,,League Average,82,19817,3091,6700,0.461,527,1487,0.355,2564,5212,0.49200000000000005,1527,2013,0.759,899,2523,3421,1742,592,398,1166,1710,8237,100.4
624,1.0,Denver Nuggets*,82,19705,3145,6613,0.47600000000000003,662,1704,0.38799999999999996,2483,4909,0.506,1859,2429,0.765,791,2652,3443,1813,605,352,1157,1719,8811,107.5
625,2.0,New York Knicks*,82,19780,3140,6867,0.457,765,2081,0.368,2375,4786,0.496,1689,2087,0.809,847,2470,3317,1757,625,475,1123,1743,8734,106.5
626,3.0,Houston Rockets,82,19880,3170,6975,0.45399999999999996,677,1843,0.36700000000000005,2493,5132,0.486,1668,2083,0.8009999999999999,962,2549,3511,1955,581,371,1110,1641,8685,105.9
627,4.0,Phoenix Suns,82,20005,3219,6844,0.47,701,1857,0.377,2518,4987,0.505,1472,1939,0.759,821,2478,3299,1945,545,357,1169,1666,8611,105.0
628,5.0,Oklahoma City Thunder*,82,20005,3066,6609,0.46399999999999997,487,1403,0.34700000000000003,2579,5206,0.495,1977,2401,0.823,903,2604,3507,1672,654,487,1156,1836,8596,104.8
629,6.0,San Antonio Spurs*,82,19780,3148,6628,0.475,685,1727,0.397,2463,4901,0.503,1521,1984,0.767,829,2603,3432,1836,602,372,1101,1556,8502,103.7
630,7.0,Golden State Warriors,82,19830,3251,7047,0.461,685,1749,0.392,2566,5298,0.484,1290,1695,0.7609999999999999,955,2370,3325,1847,737,406,1198,1806,8477,103.4
631,8.0,Miami Heat*,82,19780,3031,6301,0.48100000000000004,547,1479,0.37,2484,4822,0.515,1760,2288,0.769,790,2666,3456,1639,544,430,1142,1674,8369,102.1
632,9.0,Los Angeles Lakers*,82,19830,3128,6757,0.46299999999999997,524,1487,0.35200000000000004,2604,5270,0.494,1541,1979,0.779,989,2616,3605,1801,602,422,1073,1555,8321,101.5
633,10.0,Minnesota Timberwolves,82,19780,3090,7014,0.441,589,1565,0.376,2501,5449,0.45899999999999996,1519,1977,0.768,1085,2556,3641,1650,592,422,1398,1825,8288,101.1
634,11.0,Dallas Mavericks*,82,19705,3069,6463,0.475,645,1768,0.365,2424,4695,0.516,1437,1850,0.777,780,2618,3398,1954,557,352,1145,1575,8220,100.2
635,12.0,Memphis Grizzlies*,82,19880,3200,6801,0.47100000000000003,309,926,0.33399999999999996,2891,5875,0.49200000000000005,1486,1981,0.75,970,2391,3361,1691,771,441,1145,1705,8195,99.9
636,13.0,Indiana Pacers*,82,19780,3003,6787,0.442,585,1653,0.354,2418,5134,0.47100000000000003,1592,2035,0.782,914,2657,3571,1611,584,456,1262,1782,8183,99.8
637,14.0,Sacramento Kings,82,19855,3134,6979,0.449,428,1277,0.335,2706,5702,0.475,1455,1981,0.7340000000000001,1071,2526,3597,1675,608,391,1324,1805,8151,99.4
638,15.0,Utah Jazz,82,19880,3064,6590,0.465,435,1256,0.34600000000000003,2629,5334,0.493,1590,2061,0.7709999999999999,898,2338,3236,1921,629,484,1175,1865,8153,99.4
639,16.0,Orlando Magic*,82,19830,2956,6411,0.461,770,2103,0.366,2186,4308,0.507,1453,2101,0.6920000000000001,864,2679,3543,1636,548,384,1224,1640,8135,99.2
640,17.0,Toronto Raptors,82,19780,3144,6755,0.465,345,1091,0.316,2799,5664,0.494,1491,1976,0.755,963,2343,3306,1795,581,350,1206,1807,8124,99.1
641,18.0,Philadelphia 76ers*,82,19930,3125,6776,0.461,443,1248,0.355,2682,5528,0.485,1426,1851,0.77,850,2578,3428,1861,621,355,1063,1592,8119,99.0
642,19.0,Los Angeles Clippers,82,19855,3015,6594,0.457,513,1519,0.33799999999999997,2502,5075,0.493,1546,2187,0.7070000000000001,955,2501,3456,1813,585,402,1343,1733,8089,98.6
643,20.0,Chicago Bulls*,82,19830,3042,6587,0.462,511,1415,0.361,2531,5172,0.489,1492,2008,0.743,967,2654,3621,1827,592,468,1161,1639,8087,98.6
644,21.0,Washington Wizards,82,19930,3048,6888,0.44299999999999995,392,1182,0.332,2656,5706,0.465,1489,1999,0.745,1013,2374,3387,1592,665,502,1258,1850,7977,97.3
645,22.0,Detroit Pistons,82,19880,3056,6647,0.46,472,1256,0.376,2584,5391,0.479,1367,1854,0.737,931,2236,3167,1730,595,328,1067,1629,7951,97.0
646,23.0,Boston Celtics*,82,19780,3023,6219,0.486,408,1119,0.365,2615,5100,0.513,1459,1895,0.77,639,2542,3181,1921,676,344,1195,1678,7913,96.5
647,24.0,Portland Trail Blazers*,82,19805,2951,6599,0.447,518,1503,0.345,2433,5096,0.47700000000000004,1476,1835,0.804,996,2230,3226,1736,660,358,1070,1585,7896,96.3
648,25.0,Cleveland Cavaliers,82,19755,2886,6647,0.434,509,1489,0.342,2377,5158,0.461,1546,2075,0.745,856,2449,3305,1720,544,341,1166,1648,7827,95.5
649,26.0,Atlanta Hawks*,82,19730,2971,6429,0.462,502,1427,0.35200000000000004,2469,5002,0.494,1346,1728,0.779,762,2460,3222,1802,497,341,1118,1554,7790,95.0
650,27.0,New Orleans Hornets*,82,19830,2944,6416,0.45899999999999996,444,1232,0.36,2500,5184,0.48200000000000004,1452,1897,0.765,824,2468,3292,1691,624,359,1069,1719,7784,94.9
651,28.0,New Jersey Nets,82,20005,2918,6638,0.44,459,1337,0.34299999999999997,2459,5301,0.46399999999999997,1427,1881,0.759,909,2440,3349,1723,458,384,1152,1807,7722,94.2
652,29.0,Charlotte Bobcats,82,19805,2873,6365,0.451,393,1203,0.327,2480,5162,0.48,1511,1999,0.7559999999999999,848,2444,3292,1728,524,433,1192,1637,7650,93.3
653,30.0,Milwaukee Bucks,82,19830,2814,6544,0.43,483,1414,0.342,2331,5130,0.45399999999999996,1423,1881,0.757,862,2480,3342,1545,617,399,1103,1682,7534,91.9
654,,League Average,82,19835,3054,6660,0.45899999999999996,530,1477,0.358,2525,5183,0.48700000000000004,1525,1998,0.763,895,2499,3394,1763,601,399,1169,1698,8163,99.6
655,1.0,Denver Nuggets*,66,16040,2572,5404,0.47600000000000003,435,1311,0.332,2137,4093,0.522,1293,1760,0.735,738,2105,2843,1581,540,330,1015,1297,6872,104.1
656,2.0,San Antonio Spurs*,66,15940,2611,5463,0.478,552,1405,0.39299999999999996,2059,4058,0.507,1067,1427,0.748,683,2153,2836,1528,490,293,895,1143,6841,103.7
657,3.0,Oklahoma City Thunder*,66,15990,2462,5229,0.47100000000000003,472,1317,0.358,1990,3912,0.509,1406,1744,0.8059999999999999,726,2157,2883,1224,498,539,1079,1352,6802,103.1
658,4.0,Utah Jazz*,66,16165,2523,5531,0.456,273,845,0.32299999999999995,2250,4686,0.48,1258,1668,0.754,861,2055,2916,1439,545,385,936,1441,6577,99.7
659,5.0,Milwaukee Bucks,66,15865,2502,5652,0.44299999999999995,436,1265,0.345,2066,4387,0.47100000000000003,1095,1415,0.774,820,1983,2803,1550,548,335,929,1273,6535,99.0
660,6.0,Sacramento Kings,66,15915,2490,5712,0.436,411,1301,0.316,2079,4411,0.47100000000000003,1127,1532,0.736,882,1947,2829,1271,561,323,952,1287,6518,98.8
661,7.0,Miami Heat*,66,16040,2446,5212,0.469,370,1030,0.359,2076,4182,0.496,1238,1598,0.775,686,2060,2746,1317,585,355,1002,1282,6500,98.5
662,8.0,Phoenix Suns,66,15840,2495,5445,0.45799999999999996,444,1295,0.34299999999999997,2051,4150,0.494,1058,1397,0.757,717,2035,2752,1486,431,366,928,1233,6492,98.4
663,9.0,Houston Rockets,66,16065,2489,5543,0.449,478,1330,0.359,2011,4213,0.47700000000000004,1018,1301,0.782,769,2014,2783,1404,496,319,955,1347,6474,98.1
664,10.0,Minnesota Timberwolves,66,15940,2355,5434,0.433,473,1423,0.332,1882,4011,0.469,1281,1662,0.7709999999999999,797,2089,2886,1290,436,293,1001,1212,6464,97.9
665,11.0,New York Knicks*,66,15940,2365,5335,0.44299999999999995,517,1538,0.336,1848,3797,0.48700000000000004,1211,1634,0.741,743,2012,2755,1328,622,276,1056,1391,6458,97.8
666,12.0,Golden State Warriors,66,15915,2489,5443,0.457,524,1351,0.38799999999999996,1965,4092,0.48,951,1235,0.77,640,1947,2587,1470,528,362,915,1410,6453,97.8
667,13.0,Indiana Pacers*,66,15990,2354,5375,0.43799999999999994,392,1064,0.368,1962,4311,0.455,1349,1724,0.782,826,2070,2896,1228,523,357,925,1430,6449,97.7
668,14.0,Los Angeles Clippers*,66,15965,2439,5366,0.455,514,1441,0.35700000000000004,1925,3925,0.49,1046,1538,0.68,800,1943,2743,1385,556,315,879,1399,6438,97.5
669,15.0,Los Angeles Lakers*,66,16065,2429,5319,0.457,362,1112,0.326,2067,4207,0.491,1202,1589,0.7559999999999999,799,2251,3050,1485,390,351,997,1109,6422,97.3
670,16.0,Portland Trail Blazers,66,15965,2402,5417,0.44299999999999995,478,1382,0.34600000000000003,1924,4035,0.47700000000000004,1133,1423,0.7959999999999999,735,1949,2684,1349,528,322,935,1251,6415,97.2
671,17.0,Atlanta Hawks*,66,16165,2429,5348,0.45399999999999996,492,1330,0.37,1937,4018,0.48200000000000004,1025,1385,0.74,652,2066,2718,1481,536,303,921,1178,6375,96.6
672,18.0,Chicago Bulls*,66,15940,2467,5462,0.452,419,1117,0.375,2048,4345,0.47100000000000003,1006,1394,0.722,915,2165,3080,1527,456,388,923,1139,6359,96.3
673,19.0,Dallas Mavericks*,66,16065,2398,5412,0.44299999999999995,497,1464,0.33899999999999997,1901,3948,0.48200000000000004,1029,1334,0.7709999999999999,665,2157,2822,1380,565,337,926,1226,6322,95.8
674,20.0,Memphis Grizzlies*,66,15940,2425,5422,0.447,277,849,0.326,2148,4573,0.47,1142,1504,0.759,831,1944,2775,1290,631,345,955,1316,6269,95.0
675,21.0,Orlando Magic*,66,15965,2275,5162,0.441,670,1785,0.375,1605,3377,0.475,995,1508,0.66,742,2060,2802,1321,451,275,984,1168,6215,94.2
676,22.0,Washington Wizards,66,15865,2414,5475,0.441,344,1075,0.32,2070,4400,0.47,1008,1386,0.727,775,1975,2750,1262,527,417,1008,1405,6180,93.6
677,23.0,Philadelphia 76ers*,66,15915,2471,5516,0.44799999999999995,349,963,0.36200000000000004,2122,4553,0.466,889,1198,0.742,704,2144,2848,1453,526,340,738,1157,6180,93.6
678,24.0,New Jersey Nets,66,15890,2262,5320,0.425,507,1481,0.342,1755,3839,0.457,1113,1433,0.777,783,1879,2662,1311,493,260,995,1268,6144,93.1
679,25.0,Cleveland Cavaliers,66,15965,2261,5360,0.42200000000000004,440,1273,0.34600000000000003,1821,4087,0.446,1178,1645,0.716,841,1949,2790,1308,466,262,1017,1317,6140,93.0
680,26.0,Boston Celtics*,66,15940,2341,5086,0.46,363,988,0.36700000000000005,1978,4098,0.483,1017,1308,0.778,509,2051,2560,1557,498,362,979,1315,6062,91.8
681,27.0,Detroit Pistons,66,15965,2291,5232,0.43799999999999994,317,916,0.34600000000000003,1974,4316,0.457,1098,1461,0.752,775,1882,2657,1232,460,278,1033,1293,5997,90.9
682,28.0,Toronto Raptors,66,15965,2268,5154,0.44,365,1075,0.34,1903,4079,0.467,1085,1410,0.77,697,2074,2771,1382,429,321,1001,1532,5986,90.7
683,29.0,New Orleans Hornets,66,15940,2300,5103,0.451,259,777,0.33299999999999996,2041,4326,0.47200000000000003,1057,1397,0.757,724,1991,2715,1368,488,316,1024,1324,5916,89.6
684,30.0,Charlotte Bobcats,66,15890,2193,5293,0.414,263,892,0.295,1930,4401,0.439,1090,1462,0.746,677,1894,2571,1326,397,361,957,1249,5739,87.0
685,,League Average,66,15968,2407,5374,0.44799999999999995,423,1213,0.349,1984,4161,0.47700000000000004,1116,1482,0.752,750,2033,2784,1384,507,336,962,1291,6353,96.3
686,1.0,Denver Nuggets*,82,19905,3339,6983,0.478,521,1518,0.34299999999999997,2818,5465,0.516,1505,2148,0.701,1092,2601,3693,2002,762,533,1253,1682,8704,106.1
687,2.0,Houston Rockets*,82,19780,3124,6782,0.461,867,2369,0.366,2257,4413,0.511,1573,2087,0.754,909,2652,3561,1902,679,359,1348,1662,8688,106.0
688,3.0,Oklahoma City Thunder*,82,19830,3126,6504,0.48100000000000004,598,1588,0.377,2528,4916,0.514,1819,2196,0.828,854,2725,3579,1753,679,624,1253,1654,8669,105.7
689,4.0,San Antonio Spurs*,82,19880,3210,6675,0.48100000000000004,663,1764,0.376,2547,4911,0.519,1365,1725,0.7909999999999999,666,2721,3387,2058,695,446,1206,1427,8448,103.0
690,5.0,Miami Heat*,82,19880,3148,6348,0.496,717,1809,0.396,2431,4539,0.536,1423,1887,0.754,676,2490,3166,1890,710,441,1143,1533,8436,102.9
691,6.0,Los Angeles Lakers*,82,19755,3041,6640,0.45799999999999996,715,2015,0.355,2326,4625,0.503,1584,2289,0.6920000000000001,942,2732,3674,1818,576,429,1232,1467,8381,102.2
692,7.0,Golden State Warriors*,82,19805,3130,6840,0.45799999999999996,658,1632,0.40299999999999997,2472,5208,0.475,1378,1744,0.79,885,2801,3686,1845,567,346,1236,1753,8296,101.2
693,8.0,Dallas Mavericks,82,19980,3182,6892,0.462,606,1628,0.37200000000000005,2576,5264,0.489,1323,1669,0.7929999999999999,767,2670,3437,1906,648,454,1144,1698,8293,101.1
694,9.0,Los Angeles Clippers*,82,19730,3160,6608,0.478,627,1752,0.358,2533,4856,0.522,1342,1888,0.711,938,2475,3413,1958,784,461,1197,1716,8289,101.1
695,10.0,Sacramento Kings,82,19830,3086,6904,0.447,610,1681,0.363,2476,5223,0.474,1437,1869,0.769,943,2385,3328,1708,671,342,1199,1717,8219,100.2
696,11.0,New York Knicks*,82,19730,2996,6689,0.44799999999999995,891,2371,0.376,2105,4318,0.48700000000000004,1313,1729,0.759,890,2436,3326,1579,672,294,988,1650,8196,100.0
697,12.0,Milwaukee Bucks*,82,19830,3128,7197,0.435,601,1670,0.36,2527,5527,0.457,1251,1700,0.736,1068,2537,3605,1876,685,550,1156,1554,8108,98.9
698,13.0,Utah Jazz,82,19880,3046,6710,0.45399999999999996,507,1385,0.366,2539,5325,0.47700000000000004,1439,1883,0.764,989,2457,3446,1859,690,515,1210,1750,8038,98.0
699,14.0,Atlanta Hawks*,82,19855,3084,6644,0.46399999999999997,706,1901,0.371,2378,4743,0.501,1158,1619,0.715,758,2593,3351,2007,664,369,1219,1473,8032,98.0
700,15.0,Portland Trail Blazers,82,19855,3009,6715,0.44799999999999995,673,1904,0.353,2336,4811,0.486,1304,1680,0.7759999999999999,874,2474,3348,1784,538,353,1203,1518,7995,97.5
701,16.0,Toronto Raptors,82,19980,2979,6685,0.446,571,1665,0.34299999999999997,2408,5020,0.48,1442,1831,0.7879999999999999,871,2426,3297,1765,595,392,1124,1836,7971,97.2
702,17.0,Brooklyn Nets*,82,19855,2942,6544,0.45,628,1760,0.35700000000000004,2314,4784,0.484,1432,1958,0.731,1047,2460,3507,1668,599,391,1206,1500,7944,96.9
703,18.0,Boston Celtics*,81,19840,3001,6459,0.465,498,1390,0.358,2503,5069,0.494,1318,1698,0.7759999999999999,654,2533,3187,1843,667,365,1181,1717,7818,96.5
704,19.0,Cleveland Cavaliers,82,19730,2993,6901,0.434,547,1581,0.34600000000000003,2446,5320,0.46,1380,1826,0.7559999999999999,1004,2359,3363,1694,647,334,1149,1737,7913,96.5
705,20.0,Minnesota Timberwolves,82,19730,2943,6702,0.439,450,1475,0.305,2493,5227,0.47700000000000004,1515,2042,0.742,973,2473,3446,1836,700,387,1214,1509,7851,95.7
706,21.0,Phoenix Suns,82,19805,3061,6917,0.44299999999999995,480,1455,0.33,2581,5462,0.473,1203,1618,0.7440000000000001,959,2454,3413,1855,659,434,1278,1688,7805,95.2
707,22.0,Detroit Pistons,82,19805,2979,6638,0.449,513,1440,0.35600000000000004,2466,5198,0.474,1307,1870,0.6990000000000001,991,2463,3454,1742,574,400,1241,1623,7778,94.9
708,23.0,Indiana Pacers*,81,19590,2845,6525,0.436,555,1599,0.34700000000000003,2290,4926,0.465,1429,1915,0.746,1043,2671,3714,1645,580,513,1227,1623,7674,94.7
709,24.0,New Orleans Hornets,82,19780,2955,6589,0.44799999999999995,535,1474,0.363,2420,5115,0.473,1269,1636,0.7759999999999999,988,2426,3414,1721,520,440,1193,1673,7714,94.1
710,25.0,Orlando Magic,82,19780,3093,6904,0.44799999999999995,506,1537,0.32899999999999996,2587,5367,0.48200000000000004,1026,1359,0.755,890,2612,3502,1871,528,358,1191,1591,7718,94.1
711,26.0,Charlotte Bobcats,82,19805,2823,6649,0.425,469,1399,0.335,2354,5250,0.44799999999999995,1546,2060,0.75,917,2389,3306,1587,591,479,1153,1561,7661,93.4
712,27.0,Memphis Grizzlies*,82,19805,2964,6679,0.444,382,1107,0.345,2582,5572,0.46299999999999997,1349,1746,0.773,1059,2445,3504,1715,703,436,1144,1660,7659,93.4
713,28.0,Philadelphia 76ers,82,19755,3059,6895,0.444,518,1438,0.36,2541,5457,0.466,1004,1377,0.7290000000000001,896,2493,3389,1867,609,384,1070,1505,7640,93.2
714,29.0,Chicago Bulls*,82,19830,2926,6698,0.43700000000000006,446,1265,0.353,2480,5433,0.456,1343,1738,0.773,1026,2514,3540,1886,588,417,1171,1617,7641,93.2
715,30.0,Washington Wizards,82,19855,2910,6693,0.435,545,1495,0.365,2365,5198,0.455,1279,1746,0.733,887,2652,3539,1775,598,376,1238,1681,7644,93.2
716,,League Average,82,19816,3043,6720,0.45299999999999996,587,1636,0.359,2456,5085,0.483,1369,1818,0.753,915,2537,3453,1814,639,421,1192,1626,8041,98.1
717,1.0,Los Angeles Clippers*,82,19755,3208,6761,0.474,693,1966,0.35200000000000004,2515,4795,0.525,1741,2384,0.73,858,2668,3526,2016,703,397,1136,1767,8850,107.9
718,2.0,Houston Rockets*,82,19830,3118,6603,0.47200000000000003,779,2179,0.358,2339,4424,0.529,1814,2549,0.7120000000000001,920,2797,3717,1755,621,461,1323,1676,8829,107.7
719,3.0,Minnesota Timberwolves,82,19855,3189,7175,0.444,600,1757,0.341,2589,5418,0.478,1790,2301,0.778,1024,2644,3668,1963,718,297,1142,1504,8768,106.9
720,4.0,Portland Trail Blazers*,82,19855,3207,7134,0.45,770,2071,0.37200000000000005,2437,5063,0.48100000000000004,1569,1926,0.815,1022,2786,3808,1904,454,387,1125,1576,8753,106.7
721,5.0,Oklahoma City Thunder*,82,19805,3194,6782,0.47100000000000003,664,1839,0.361,2530,4943,0.512,1653,2052,0.8059999999999999,887,2781,3668,1794,678,501,1256,1858,8705,106.2
722,6.0,San Antonio Spurs*,82,19755,3326,6844,0.486,698,1757,0.397,2628,5087,0.517,1289,1642,0.785,762,2786,3548,2064,604,420,1180,1495,8639,105.4
723,7.0,Phoenix Suns,82,19755,3172,6845,0.46299999999999997,765,2055,0.37200000000000005,2407,4790,0.503,1520,2004,0.758,928,2601,3529,1563,688,374,1258,1798,8629,105.2
724,8.0,Dallas Mavericks*,82,19830,3249,6858,0.474,721,1877,0.384,2528,4981,0.508,1378,1733,0.795,840,2514,3354,1935,704,356,1110,1636,8597,104.8
725,9.0,Denver Nuggets,82,19755,3147,7042,0.447,702,1959,0.358,2445,5083,0.48100000000000004,1563,2154,0.726,1009,2717,3726,1838,615,459,1305,1890,8559,104.4
726,10.0,Golden State Warriors*,82,19830,3236,7005,0.462,774,2037,0.38,2462,4968,0.496,1303,1731,0.753,896,2819,3715,1912,642,407,1247,1784,8549,104.3
727,11.0,Los Angeles Lakers,82,19705,3139,6980,0.45,774,2032,0.381,2365,4948,0.478,1390,1835,0.757,745,2620,3365,2006,611,446,1239,1627,8442,103.0
728,12.0,Miami Heat*,82,19880,3142,6272,0.501,665,1829,0.364,2477,4443,0.5579999999999999,1431,1884,0.76,627,2397,3024,1847,732,367,1212,1596,8380,102.2
729,13.0,Toronto Raptors*,82,19955,2992,6718,0.445,713,1917,0.37200000000000005,2279,4801,0.475,1608,2055,0.782,935,2552,3487,1737,577,343,1159,1882,8305,101.3
730,14.0,Atlanta Hawks*,82,19830,3061,6688,0.45799999999999996,768,2116,0.363,2293,4572,0.502,1392,1782,0.7809999999999999,713,2565,3278,2041,680,326,1251,1577,8282,101.0
731,15.0,Detroit Pistons,82,19780,3182,7124,0.447,507,1580,0.321,2675,5544,0.483,1415,2111,0.67,1196,2525,3721,1714,687,395,1193,1666,8286,101.0
732,16.0,Washington Wizards*,82,20055,3177,6920,0.45899999999999996,647,1704,0.38,2530,5216,0.485,1253,1715,0.731,886,2573,3459,1909,668,377,1204,1675,8254,100.7
733,17.0,Sacramento Kings,82,19830,3026,6766,0.447,491,1475,0.33299999999999996,2535,5291,0.479,1698,2237,0.759,990,2656,3646,1547,587,318,1249,1849,8241,100.5
734,18.0,New Orleans Pelicans,82,19855,3101,6761,0.45899999999999996,486,1303,0.373,2615,5458,0.479,1489,1936,0.769,933,2486,3419,1745,647,523,1129,1857,8177,99.7
735,19.0,Philadelphia 76ers,82,19855,3108,7150,0.435,577,1847,0.312,2531,5303,0.47700000000000004,1362,1918,0.71,949,2556,3505,1791,765,330,1384,1844,8155,99.5
736,20.0,New York Knicks,82,19855,3027,6739,0.449,759,2038,0.37200000000000005,2268,4701,0.48200000000000004,1271,1670,0.7609999999999999,870,2437,3307,1641,631,367,1063,1815,8084,98.6
737,21.0,Brooklyn Nets*,82,19880,2931,6391,0.45899999999999996,709,1922,0.369,2222,4469,0.49700000000000005,1508,2002,0.753,721,2407,3128,1714,705,311,1191,1777,8079,98.5
738,22.0,Cleveland Cavaliers,82,19930,3036,6955,0.43700000000000006,584,1640,0.35600000000000004,2452,5315,0.461,1398,1861,0.7509999999999999,989,2629,3618,1738,579,304,1163,1640,8054,98.2
739,23.0,Charlotte Bobcats*,82,19905,2976,6730,0.442,516,1471,0.35100000000000003,2460,5259,0.46799999999999997,1474,2000,0.737,776,2724,3500,1778,499,421,1010,1493,7942,96.9
740,24.0,Indiana Pacers*,82,19780,2949,6573,0.449,550,1542,0.35700000000000004,2399,5031,0.47700000000000004,1485,1907,0.779,834,2831,3665,1651,550,446,1237,1675,7933,96.7
741,25.0,Orlando Magic,82,19955,3022,6784,0.445,563,1596,0.353,2459,5188,0.474,1307,1714,0.763,794,2654,3448,1726,630,350,1222,1678,7914,96.5
742,26.0,Boston Celtics,82,19730,2996,6883,0.435,575,1729,0.33299999999999996,2421,5154,0.47,1325,1706,0.777,980,2505,3485,1726,584,343,1261,1743,7892,96.2
743,27.0,Memphis Grizzlies*,82,19805,3122,6723,0.46399999999999997,405,1147,0.353,2717,5576,0.48700000000000004,1235,1666,0.741,950,2526,3476,1792,631,375,1124,1568,7884,96.1
744,28.0,Milwaukee Bucks,82,19880,2952,6737,0.43799999999999994,548,1553,0.353,2404,5184,0.46399999999999997,1377,1843,0.747,971,2399,3370,1760,541,403,1238,1713,7829,95.5
745,29.0,Utah Jazz,82,19780,2951,6652,0.444,543,1577,0.344,2408,5075,0.474,1346,1803,0.747,904,2477,3381,1664,570,366,1200,1699,7791,95.0
746,30.0,Chicago Bulls*,82,19930,2843,6577,0.43200000000000005,508,1459,0.348,2335,5118,0.456,1486,1908,0.779,937,2683,3620,1860,594,424,1223,1565,7680,93.7
747,,League Average,82,19840,3093,6806,0.45399999999999996,635,1766,0.36,2458,5040,0.488,1462,1934,0.7559999999999999,895,2611,3505,1804,630,386,1201,1697,8283,101.0
748,1.0,Golden State Warriors*,82,19730,3410,7137,0.478,883,2217,0.39799999999999996,2527,4920,0.514,1313,1709,0.768,853,2814,3667,2248,762,496,1185,1628,9016,110.0
749,2.0,Los Angeles Clippers*,82,19730,3228,6830,0.473,827,2202,0.376,2401,4628,0.519,1468,2067,0.71,784,2711,3495,2031,640,409,1012,1749,8751,106.7
750,3.0,Dallas Mavericks*,82,19880,3255,7036,0.46299999999999997,732,2082,0.35200000000000004,2523,4954,0.509,1386,1843,0.752,858,2608,3466,1846,663,371,1062,1644,8628,105.2
751,4.0,Oklahoma City Thunder,82,19830,3184,7119,0.447,632,1864,0.33899999999999997,2552,5255,0.486,1524,2020,0.754,1052,2844,3896,1681,598,454,1205,1829,8524,104.0
752,5.0,Toronto Raptors*,82,19855,3108,6829,0.455,726,2060,0.35200000000000004,2382,4769,0.499,1585,2014,0.787,881,2526,3407,1701,615,357,1057,1712,8527,104.0
753,6.0,Houston Rockets*,82,19805,3032,6832,0.444,933,2680,0.348,2099,4152,0.506,1525,2133,0.715,958,2624,3582,1820,777,407,1366,1803,8522,103.9
754,7.0,San Antonio Spurs*,82,19955,3208,6854,0.46799999999999997,677,1847,0.36700000000000005,2531,5007,0.505,1368,1754,0.78,806,2772,3578,2000,657,444,1146,1564,8461,103.2
755,8.0,Cleveland Cavaliers*,82,19780,3089,6739,0.45799999999999996,826,2253,0.36700000000000005,2263,4486,0.504,1453,1934,0.7509999999999999,911,2612,3523,1814,603,340,1171,1510,8457,103.1
756,9.0,Portland Trail Blazers*,82,19855,3175,7049,0.45,807,2231,0.36200000000000004,2368,4818,0.491,1272,1589,0.8009999999999999,879,2881,3760,1799,525,372,1117,1494,8429,102.8
757,10.0,Atlanta Hawks*,82,19730,3121,6699,0.466,818,2152,0.38,2303,4547,0.506,1349,1735,0.778,715,2611,3326,2111,744,380,1167,1457,8409,102.5
758,11.0,Phoenix Suns,82,19880,3178,7038,0.452,698,2048,0.341,2480,4990,0.49700000000000005,1343,1767,0.76,896,2643,3539,1659,700,385,1238,1744,8397,102.4
759,12.0,Denver Nuggets,82,19880,3099,7158,0.433,660,2032,0.325,2439,5126,0.47600000000000003,1462,1991,0.7340000000000001,1012,2653,3665,1788,641,367,1166,1882,8320,101.5
760,13.0,Boston Celtics*,82,19880,3193,7211,0.44299999999999995,660,2021,0.327,2533,5190,0.488,1266,1678,0.754,910,2685,3595,2009,674,294,1133,1738,8312,101.4
761,14.0,Sacramento Kings,82,19855,3010,6617,0.455,461,1350,0.341,2549,5267,0.484,1829,2400,0.762,895,2728,3623,1667,550,324,1333,1696,8310,101.3
762,15.0,Chicago Bulls*,82,19880,3001,6797,0.442,645,1825,0.353,2356,4972,0.474,1618,2067,0.7829999999999999,959,2792,3751,1781,514,476,1145,1495,8265,100.8
763,16.0,New Orleans Pelicans*,82,19780,3108,6795,0.457,586,1583,0.37,2522,5212,0.484,1345,1790,0.7509999999999999,942,2621,3563,1806,553,510,1087,1530,8147,99.4
764,17.0,Los Angeles Lakers,82,19930,3054,7020,0.435,532,1546,0.344,2522,5474,0.461,1433,1935,0.741,952,2647,3599,1715,578,366,1086,1741,8073,98.5
765,18.0,Washington Wizards*,82,19955,3139,6790,0.462,497,1381,0.36,2642,5409,0.488,1305,1758,0.742,862,2801,3663,1969,601,378,1233,1707,8080,98.5
766,19.0,Detroit Pistons,82,19830,3041,7038,0.43200000000000005,703,2043,0.344,2338,4995,0.46799999999999997,1292,1838,0.703,1051,2630,3681,1771,623,383,1099,1559,8077,98.5
767,20.0,Memphis Grizzlies*,82,19905,3097,6763,0.45799999999999996,423,1246,0.33899999999999997,2674,5517,0.485,1445,1869,0.773,856,2634,3490,1777,700,347,1094,1567,8062,98.3
768,21.0,Brooklyn Nets*,82,19930,3069,6804,0.451,541,1633,0.331,2528,5171,0.489,1359,1817,0.748,846,2627,3473,1716,576,340,1133,1579,8038,98.0
769,22.0,Milwaukee Bucks*,82,19930,3083,6722,0.45899999999999996,545,1500,0.363,2538,5222,0.486,1312,1734,0.757,876,2574,3450,1932,789,403,1373,1814,8023,97.8
770,23.0,Minnesota Timberwolves,82,19805,2986,6820,0.43799999999999994,406,1223,0.332,2580,5597,0.461,1638,2110,0.7759999999999999,949,2406,3355,1771,668,327,1231,1571,8016,97.8
771,24.0,Indiana Pacers,82,19855,2998,6824,0.439,612,1740,0.35200000000000004,2386,5084,0.469,1373,1817,0.7559999999999999,856,2822,3678,1757,505,375,1147,1742,7981,97.3
772,25.0,Orlando Magic,82,19755,3076,6792,0.45299999999999996,554,1598,0.34700000000000003,2522,5194,0.486,1141,1565,0.7290000000000001,822,2607,3429,1692,647,314,1221,1714,7847,95.7
773,26.0,Utah Jazz,82,19705,2900,6492,0.447,610,1781,0.34299999999999997,2290,4711,0.486,1391,1929,0.721,988,2617,3605,1632,623,489,1256,1583,7801,95.1
774,27.0,Miami Heat,82,19730,2885,6330,0.456,556,1659,0.335,2329,4671,0.499,1438,1940,0.741,747,2461,3208,1626,642,372,1214,1636,7764,94.7
775,28.0,Charlotte Hornets,82,19905,2913,6932,0.42,498,1566,0.318,2415,5366,0.45,1397,1867,0.748,820,2793,3613,1654,499,448,976,1494,7721,94.2
776,29.0,Philadelphia 76ers,82,19805,2765,6777,0.408,692,2160,0.32,2073,4617,0.449,1320,1953,0.6759999999999999,978,2536,3514,1683,789,487,1453,1778,7542,92.0
777,30.0,New York Knicks,82,19855,2882,6726,0.428,560,1614,0.34700000000000003,2322,5112,0.45399999999999996,1211,1575,0.769,867,2443,3310,1746,575,382,1206,1768,7535,91.9
778,,League Average,82,19840,3076,6852,0.449,643,1838,0.35,2433,5014,0.485,1405,1873,0.75,893,2657,3550,1807,634,393,1177,1658,8201,100.0
779,1.0,Golden State Warriors*,82,19880,3489,7159,0.48700000000000004,1077,2592,0.41600000000000004,2412,4567,0.528,1366,1790,0.763,816,2972,3788,2373,689,498,1245,1701,9421,114.9
780,2.0,Oklahoma City Thunder*,82,19830,3372,7082,0.47600000000000003,678,1945,0.349,2694,5137,0.524,1616,2067,0.782,1071,2916,3987,1883,603,487,1305,1691,9038,110.2
781,3.0,Sacramento Kings,82,19805,3283,7083,0.46399999999999997,660,1839,0.359,2623,5244,0.5,1514,2089,0.725,868,2760,3628,2009,733,368,1326,1676,8740,106.6
782,4.0,Houston Rockets*,82,19830,3094,6847,0.452,878,2533,0.34700000000000003,2216,4314,0.514,1671,2407,0.6940000000000001,930,2601,3531,1821,821,430,1307,1790,8737,106.5
783,5.0,Boston Celtics*,82,19780,3216,7318,0.439,717,2142,0.335,2499,5176,0.483,1520,1929,0.7879999999999999,950,2733,3683,1981,752,348,1127,1796,8669,105.7
784,6.0,Portland Trail Blazers*,82,19805,3167,7040,0.45,864,2336,0.37,2303,4704,0.49,1424,1889,0.754,948,2782,3730,1748,562,380,1200,1782,8622,105.1
785,7.0,Los Angeles Clippers*,82,19830,3141,6759,0.465,797,2190,0.364,2344,4569,0.513,1490,2152,0.6920000000000001,721,2727,3448,1873,709,460,1063,1746,8569,104.5
786,8.0,Cleveland Cavaliers*,82,19855,3171,6888,0.46,880,2428,0.36200000000000004,2291,4460,0.514,1333,1783,0.748,873,2777,3650,1861,551,317,1114,1666,8555,104.3
787,9.0,Washington Wizards,82,19755,3238,7033,0.46,709,1983,0.358,2529,5050,0.501,1349,1849,0.73,743,2688,3431,2005,708,323,1186,1708,8534,104.1
788,10.0,San Antonio Spurs*,82,19705,3289,6797,0.484,570,1518,0.375,2719,5279,0.515,1342,1672,0.8029999999999999,770,2831,3601,2010,677,485,1071,1433,8490,103.5
789,11.0,Charlotte Hornets*,82,19855,3036,6922,0.439,873,2410,0.36200000000000004,2163,4512,0.479,1534,1941,0.79,734,2869,3603,1778,595,438,1030,1487,8479,103.4
790,12.0,Atlanta Hawks*,82,19830,3168,6923,0.45799999999999996,815,2326,0.35,2353,4597,0.512,1282,1638,0.7829999999999999,679,2772,3451,2100,747,486,1226,1570,8433,102.8
791,13.0,Toronto Raptors*,82,19780,3006,6669,0.451,708,1915,0.37,2298,4754,0.483,1702,2190,0.777,836,2724,3560,1536,636,449,1073,1610,8422,102.7
792,14.0,New Orleans Pelicans,82,19780,3153,7040,0.44799999999999995,702,1951,0.36,2451,5089,0.48200000000000004,1415,1823,0.7759999999999999,782,2712,3494,1818,633,342,1102,1713,8423,102.7
793,15.0,Minnesota Timberwolves,82,19880,3095,6668,0.46399999999999997,455,1347,0.33799999999999997,2640,5321,0.496,1753,2213,0.792,821,2587,3408,1916,656,375,1231,1696,8398,102.4
794,16.0,Dallas Mavericks*,82,20005,3064,6900,0.444,806,2342,0.344,2258,4558,0.495,1454,1831,0.794,751,2781,3532,1813,560,306,1047,1595,8388,102.3
795,17.0,Indiana Pacers*,82,19880,3142,6985,0.45,663,1889,0.35100000000000003,2479,5096,0.486,1430,1872,0.764,847,2779,3626,1741,742,391,1219,1641,8377,102.2
796,18.0,Orlando Magic,82,19905,3242,7120,0.455,636,1818,0.35,2606,5302,0.49200000000000005,1249,1649,0.757,843,2709,3552,1933,673,417,1155,1701,8369,102.1
797,19.0,Detroit Pistons*,82,19880,3111,7087,0.439,740,2148,0.345,2371,4939,0.48,1399,2095,0.6679999999999999,1021,2777,3798,1594,573,304,1110,1557,8361,102.0
798,20.0,Denver Nuggets,82,19830,3093,7003,0.442,656,1943,0.33799999999999997,2437,5060,0.48200000000000004,1513,1974,0.7659999999999999,941,2718,3659,1858,609,395,1202,1723,8355,101.9
799,21.0,Chicago Bulls,82,19905,3165,7170,0.441,651,1753,0.371,2514,5417,0.46399999999999997,1354,1720,0.787,907,2889,3796,1870,495,470,1141,1545,8335,101.6
800,22.0,Phoenix Suns,82,19705,3051,7018,0.435,738,2118,0.348,2313,4900,0.47200000000000003,1431,1905,0.7509999999999999,943,2733,3676,1701,632,313,1410,1858,8271,100.9
801,23.0,Miami Heat*,82,19830,3150,6697,0.47,498,1480,0.336,2652,5217,0.508,1406,1889,0.7440000000000001,807,2811,3618,1709,553,531,1155,1502,8204,100.0
802,24.0,Memphis Grizzlies*,82,19830,3019,6859,0.44,504,1521,0.331,2515,5338,0.47100000000000003,1584,2024,0.7829999999999999,916,2497,3413,1697,724,350,1090,1783,8126,99.1
803,25.0,Milwaukee Bucks,82,19830,3145,6740,0.467,440,1277,0.345,2705,5463,0.495,1392,1863,0.747,858,2559,3417,1895,672,475,1247,1695,8122,99.0
804,26.0,Brooklyn Nets,82,19755,3136,6920,0.45299999999999996,531,1508,0.35200000000000004,2605,5412,0.48100000000000004,1286,1699,0.757,863,2614,3477,1829,627,332,1212,1476,8089,98.6
805,27.0,New York Knicks,82,19805,3022,6886,0.439,610,1762,0.34600000000000003,2412,5124,0.47100000000000003,1411,1753,0.805,850,2788,3638,1682,467,466,1099,1616,8065,98.4
806,28.0,Utah Jazz,82,19955,2957,6593,0.449,694,1956,0.355,2263,4637,0.488,1402,1885,0.7440000000000001,880,2665,3545,1555,631,425,1224,1655,8010,97.7
807,29.0,Philadelphia 76ers,82,19805,2970,6887,0.431,764,2255,0.33899999999999997,2206,4632,0.47600000000000003,1284,1850,0.6940000000000001,777,2605,3382,1765,680,495,1343,1780,7988,97.4
808,30.0,Los Angeles Lakers,82,19730,2880,6956,0.414,639,2016,0.317,2241,4940,0.45399999999999996,1583,2028,0.7809999999999999,878,2645,3523,1478,593,337,1124,1662,7982,97.3
809,,League Average,82,19828,3136,6935,0.452,698,1975,0.354,2437,4960,0.491,1450,1916,0.757,854,2734,3588,1828,643,406,1179,1662,8419,102.7
